Query	Correction
a´ðalpersóna	aðalpersóna
a´gústa	Ágústa
a´r	ár
a´ra	ára
a´rangur	alrangur;árangur
a´wð	að
aæða	æða
aær	ær
aætir	áætlir
aætlun	áætlun
aálsma	asma;sálma
aáttmála	sáttmála
ábótavanur	ábótavant
ábótavön	ábótavant
ábyrð	ábyrgð
ábyrgður	ábyrgðar;ábyrgur
ábyrgur	ábyrgur
ad	að
ađ	að
aðæf	aðhæf
aðælbygging	aðalbygging
aðaige	aðsigi
aðal-	aðal
aðal(	aðal
aðaldundur	aðalfundur
aðalega	aðallega
aðaleikari	aðalleikari
aðalgangujr	aðalgangur
aðalina	aðaliðna
aðallegur	aðalleggur
aðallsteinn	aðalsteinn
aðalperona	aðalpersóna
aðalperóna	aðalpersóna
aðalpersæona	aðalpersóna
aðalpersona	aðalpersóna
aðalpersonur	aðalpersónur
aðalpersoona	aðalpersóna
aðalrettur	aðalréttur
aðalrétutr	aðalréttur
aðaluppdréttur	aðaluppdráttur
aðalþ	aðal
aðans	arans
aðap	aðal
aðarari	daðrari;annarri
aðat	aðal
aðatt	aðan;aðall
aðbur	aðburð
aðð	að
aðdáðandi	aðdáandi
aðdandi	aðdáandi
aðdáunsverð	aðdáunarverð
aðdáunsverða	aðdáunarverða
aðdáunverður	aðdáunarverður
aðdráttarabl	aðdráttarafl
aðdróttnun	aðdróttun
aðe	að
aðeinn	aðeins
aðf´ra	aðfara
aðfæuttur	aðfluttur
ađfangadogskvöld	aðfangadagskvöld
aðfangar	áfangar;aðfanga
aðfangi	áfangi
aðfangur	aðgangur
aðfararnir	aðfarirnar
aðfardagskvöld	aðfangadagskvöld
aðfer	aðferð
aðferður	aðferðir
aðferp	aðferð
aðferpir	aðferðir
aðfö-ng	aðföng
aðg	að
aðgái	aðgát
aðgan	aðgang;angan
aðgangalegur	aðgengilegur
aðgangleg	aðgengileg
aðgangsmál	aðgengismál
aðgangsstýrðut	aðgangsstýrður
aðgangsstyrt	aðgangsstig;aðgangsstýrt
aðgangstýrður	aðgangsstýrður
aðgengi­leg­a	aðgengilega
aðgengi­leg­ir	aðgengilegir
aðgengi­leg­ur	aðgengilegur
aðgengi­lög­ur	aðgengilegur
aðgerðahnappur	aðgerðarhnappur
aðgerðrsinni	aðgerðinni;aðgerðasinni
aðgerður	aðgerð;aðgerðar
aðhaldsemi	aðhaldssemi
aðhillast	aðhyllast
aðhllying	aðhlynning
aðhllyning	aðhlynning
aðhlúun	aðhlynning
aðhlyninn	aðhlynning
aðhlyninng	aðhlynning
aðhlynnt	aðhlynning
aðhlynt	óðlynt;aðhlynning
aðid	aðild
aðilðafélag	aðildarfélag
aðildafélög	aðildarfélög
aðilðarfélag	aðildarfélag
aðildarrík	aðildarríki
aðildi	aðili
aðilji	aðili
aðils	aðila
aðker	baðker
aðkjósanlegur	auðkjósanlegur
aðkonu	aðkomu
aðladandi	aðlaðandi
aðlag	aðlaga
aðlagarinnar	aðlagnarinnar
aðleg	aðlæg;auðleg
aðlega	aðlaga;aðlæga;auðlega
aðlegt	auðlegt;aðlægt;auðlegt
aðlektu	afleitu
aðlessan	vaðleysan
aðlhyning	aðhlynning
aðliggandi	aðliggjandi
aðlynning	aðhlynning
aðótt	æðótt;aðdróttun
aðr	að;áður
aðrað	aðra;jaðrað;aldrað
aðraður	jaðraður;aldraður
aðrari	aðrar;annarri
aðrennslisá	aðrennslis
aðrer	aðrir
aðrétt	afrétt
aðrie	aðrir
aðrír	aðrir
aðriri	aðrir
aðrta	aðra
aðrún	Auðrún
aðs	að;auðs
aðsæki	aðsækni
aðsættin	aðsætin
aðsettur	aðsetur
aðsígi	aðsigi
aðsígin	aðsiginu
aðsjáanlegur	auðsjáanlegur
aðskyljanleg	aðskiljanleg
aðskylt	aðskilið
aðsóknaður	aðsóknar;aðsókn
aðst	baðst
aðsta	aðstaða;æðsta
aðstað	aðstaða
aðstæd	aðstæður
aðstæða	aðstæðna
aðstæðenfur	aðstandendur;aðstæður
aðstædum	aðstæðum
aðstæður´	aðstæður
aðstæur	aðstæður
aðstandadi	aðstandandi
aðstandenður	aðstandendur
aðstð	aðstoð
aðstendenda	aðstandenda
aðstóð	aðstoð
aðstöðuð	aðstöðu
aðsvífandi	aðvífandi
aðu	að
ađur	áður
aðurð	afurð
aðv	að
aðveinar	aðreinar;akreinar
aðvelt	auðvelt
aðven	aðventa
aðvent	aðventu
aðynnir	ynnir
æa	á
æfingarakstur	æfingaakstur
æfingur	æfingar;æfing
æfintýri	ævintýri
ægló	Eygló
æji	æi;æli
æk	læk;æl
æn	ein
æna	eina
aetla	ætla;áætla
ættingar	ættingjar
æv	æf
æx	æs;ax
afhentann	afhentan
afleiddlega	afleitlega
afþreyging	afþreying
afþýða	afþíða
ag	af;dag;að
ág	lág;át
ágleif	Áleif
agurka	agúrka
águrka	agúrka
águst	ágúst
àgúst	ágúst
ágústa	Ágústa
áhættur	áhætta
áhugamál	áhugamál
áhugaver	áhugavert
áhyggur	áhyggjur
aímaríska	ameríska
ák	á;ál;ái
aká	aka
akámu	kámu
akíra	skíra
akureyre	Akureyri
akureyris	Akureyri
akureyry	Akureyri
akureyti	Akureyri
akurkykkja	akuryrkja
akvađ	ákvað
akvað	ákvað
akvaða	ákvaða
akvæð	atkvæð
ákvæð	ákvæði
akveða	ákveða
ákveda	ákveða
akveðinn	ákveðinn
ákveðja	ákveða
akveðnum	ákveðnum
akvöðrun	ákvörðun
akxa	aka
akyldi	skyldi
akyrta	skyrta
alæg	aðlæg
alæmur	slæmur
alain	alan
alasta	alast
alastan	alan
alátta	slátta
alaugu	laugu
albania	Albanía
albú,	albúm
albúm	albúm
albún	albúm
albúum	albúmum
alce	alice
aldamot	aldamót
aldarfjörðung	aldarfjórðung
aldeis	aldeilis
aldetré	aldintré
aldgamalt	eldgamalt
alðgamalt	allgamalt
aldíd	aldís
aldirnar.	aldirnar
aldr	aldri
aldre	aldrei
aldreg	aldrei
aldrey	aldrei
aldrin	aldri;aldurinn
aldrnara	aldurnara
aldurin	aldurinn
aldursgreinand	aldursgreinandi
aldurshniginn	aldurhniginn
alefi	alefli
aleinn.	aleinn
alérefti	lérefti
alesandra	Alexandra;Alessandro
alesandro	Alessandro
aleutíska	lettíska
alexandea	Alexander;Alexandra
alexander	Alexander
alexandfa	Alexandra
alexandre	Alexandra
alexis	Alexíus
alexsandra	Alexandra
aleygða	aleyða
alf	af
alfeins	aleins
alfhildarson	Álfhildarson
alfitar	aflitar
alflest	allflest
alfræđibók	alfræðibók
alfre	Alfreð
alfrun	alfriðun
alfrún	Álfrún
alftanes	Álftanes
alfur	álfur;Álfur
alfuri	alfari
alfurin	alfarin
algangsta	algangsa;algengasta
algegnur	algengur
algegt	algengt
algen	algeng
algendast	algengast
algendasta	algengasta
algerna	algera
algidur	algildur
algínat	algat
algolin	algolinu
algos	aðalgos
algrimi	algrími
alhambra	alhamra
"alheimsins"","	alheimsins
alicja	Alice
alinskur	linsur
alinuð	linuð
alinyð	aldinið
alisa	alísa
álitshnekkur	álitshnekkir
alkala	alkana
alkenda	alhenda
alkiðun	alfriðun
alkir	allir
alkis	alki
alkóholista	alkóhólista
alkostar	valkostar
alkýl	alkul
all	alla
allae	alla
allah	alla
allann	allan
alldraður	aldraður
allfarið	alfarið
allfur	allur
allgent	algengt
allheimskur	alheimskur
allheimsur	alheimskur
allherja	allsherjar
allherjar	allsherjar
alli🚾🚾🚾🚾	allt
allikur	allríkur
allkenda	alhenda
allkunngur	alkunnugur
allmannavarnir	almannavarnir
allmenilega	almennilega
allmenilegur	almennilegur
allmenn	almenn
allmennilega	almennilega
allmennings	almennings
allmenns	almenns
allmennt	almennt
allmennur	almennur
allseki	alseki
allsgóður	algóður
allshendis	allsendis
allsir	allir;Alsír
allskonae	allskonar
allskýjað	alskýjað
allskynd	allskyns
allsnægtyir	allsnægtir
alltag	alltaf
alltav	alltaf
alltstór	allstór
allvanalegur	alvanalegur
allvitur	alvitur
allþektur	alþekktur
allþing	alþing
allþingi	alþingi
allþjóðadómstóll	alþjóðadómstóll
almanna	almenna
almannar	almennar
almannlegur	karlmannlegur
almannur	almennur
almar	Almar;Almarr
almen	almenn
almenalega	almennilega
almennann	almennan
almennatengil	almannatengil
almennlegur	almennilegur
almenntur	almennur
almennurlega	almennilega
almentur	almennur
almer	almar
almest	aflmest
alminnilega	almennilega
almmenn	almenn
almmenur	almennur
almúgut	almúginn
almvitur	alvitur
almvítur	alhvítur
áln	álna
alnætti	almætti
alnasta	galnasta
alnnokkuð	allnokkuð
alnokkuð	allnokkuð
alpumst	álpumst
alrabil	aldabil
alredi	alrefi
alríkur	allríkur
alsal	alsæl
alska	elska
alskins	allskyns
alsl	alls
alsnæ	asna
alsnæg	allsnægt
alsnægta	allsnægta
alsnjóugur	snjóugur
alsráðandi	allsráðandi
alsrei	aldrei
alsskyns	allskyns
alster	allsterk
alsýn	alsýni
alsystkini	alsystkinin
alsytur	alsystur
altælda	aldæla
altaf	alltaf
altaíska	alkalíska
altarana	altaranna
altarann	saltarann
altav	alta;alltaf
altennt	almennt
altent	alhent;altént
althing	alþing;alþingi;Alþingi
altt	allt
alun	laun
alunnast	alkunnast
alurði	aliði;afurð;afurðir
alvaldið	alvaldi;alvaldur
alvalegur	alvarlegur
alvef	alveg
alvelður	aflveður
alverlegur	alvarlegur
alvíkingur	Dalvíkingur
alvitr	alvitur
alvítur	alvitur
alvoru	alvöru
alvörugeifnn	alvörugefinn
alvwg	alveg
alxander	Alexander
alxin	alin
alþænni	alþánni
alþenni	almenni
alþingishúsið,	alþingishúsið
alþingu	alþingi;Alþingi
alþinni	alþingi;Alþingi
alþínni	alþíði
alþjóðahei	alþjóðaheri
alþjódlegar	alþjóðlegar
alþjódlegur	alþjóðlegur
alþjóðleur	alþjóðlegur
alþonni	alþánni
alþónni	alþánni
alþönni	alþánni
alþúnni	alþánni
alþýnni	alþánni
am	ám
amaka	maka;ómaka
amalgam	amalegum
aman	saman;gaman
amapa	ramapa;amaba
amariga	marga
amarika	Ameríka
amarleg	amaleg
amaro	amar
amax	max
ambót	ambátt
ameæ	ama
amerar	merar
ameriku	Ameríku
amilíu	Amalíu;Emilíu;Emelíu
amingi	aumingi
aminingur	almenningur
áminnig	áminning
amlætis	samlætis
amlauni	launi
amlin	alin
ammóníak	ammoníak
amms	amma
ammu	ömmu;amma
ammunnar	ömmunnar
amorist	morsist
ampíra	vampíra
amúra	múra
amynning	áminning
amþraut	alþraut
ana-	ana
anaat	hanaat
anaðist	annaðist
ánæg	ánægð
anægdur	ánægður
anægður	ánægður
ánægdur	ánægður
ánægjuleg	ánægjuleg
ánægjulegt	ánægjulegt
ánægjulegur	ánægjulegur
anaegt	ánægt
ánægur	ánægður
anal	aðal
anananas	ananas;ansans
ananans	ananas;ansans
anarkískur	antarktískur
anarkó	arnarkló
anars	annars
anast	annast
anbaga	ambaga
anbar	annar
anbögur	ambögur
andaðisk	andaðist
andadrátt	andardrátt
andadráttur	andardráttur
andæfingi	andæfingin;andæfing
andán	andan
andarauk	andartök
andardrættur	andardrættir;andardráttur
andardratt	andardrátt
andardtáttur	andardráttur
andatúngum	sandatúnum
andazt	andast
anddryi	anddyri
anddryri	anddyri
anddyrir	anddyri
anden	andan
andere	Anders
andira	Andra
andirinu	andrinu;anddyrinu
andka	anda
andkaf	andköf
andköt	andköf
andlátit	andláti
andletið	andlitið
andlislaus	andlitslaus
andlislausur	andlitslausir
andlistdrættina	andlitsdrættina
andlistdrættir	andlitsdrættir
andlitiđ	andlitið
andm´l	andmæl;andmæli
andpænis	andspænis
andr´s	Andrés
andrésína	Andresína
andrumsloftið	andrúmsloftið
andrýmii	andrými
andsæt	andstætt
andsalt	andsvalt
andset	handset
andseta	andsetna
andsetja	handsetja
andsettur	andsetinn
andskottin	andskotinn
andslitin	andlitin;andarslitrin
anðstaða	aðstaða
andstæ	andstæð
andstæd	andstæð
andstæda	andstæða
andstædur	andstæður
anðstæður	aðstæður
andstæöa	andstæða
andstygg	andstyggð
andtakt	andakt
andvarða	landvarða
andvarið	andsvarið
andvegi	öndvegi
andvon	andvön
andvörð	landvörð
andyii	andi
andyri	anddyri;Andri
andyrí	anddyri;Andri
andýri	anddyri;Andri
andyrið	anddyrið
andyrinu	anddyrinu
andyrr	andir;anddyri
andyrri	anddyri
anér	anir
angantry	Angantý
angantýxs	Angantýs
angel	Angela
angistafullur	angistarfullur
angnalok	augnalok
angnalokin	augnalokin
angry	angri
anisíum	asíum
ankannanlega	ankannalega
ankannanlegur	ankannalegur
ankinum	tankinum
anl	al
anlátið	andlátið
anliti	andliti
anlitið	andlitið
annabel	Annabella
annadð	annað
annahvort	annaðhvort
annalín	fannalín
annanð	annað
annann	annan
annannu	annanna
annarrinnar	annarinnar
annarro	annarra;annarri
annarrra	annarra
annarsamur	annasamur
annat	annað
annelies	Annels;Anneli
annesu	annesi
annkannalega	ankannalega
annkannalegur	ankannalegur
annkannanlega	ankannalega
annnan	annan
annnar	annar
annnars	annars
anns	manns
annur	önnur;annar
anný	Anný
anríkur	annríkur
anrríki	annríki
ansetin	andsetin
anskkotin	aðskotin
anskota	andskota
anskotan	andskotans
anskotanum	andskotanum
ansrk	dansk
anstandendur	aðstandendur
antilópi	antilópu
antlit	andlit
antonn	Anton
antsflug	landsflug
anum	ánum
anur	vanur
aö	að
aóa	sóa
aofa	sofa
aögu	sögu;atlögu
aonu	konu
aöunn	ölunn;önn;Þórunn
ap	að
apáú	apá;Apá;spá
apðstoða	aðstoða
apelsina	appelsína
apelsíni	appelsíni
apelsinu	appelsínu
apelsínu	appelsínu
apelsínugulur	appelsínugulur
apesína	appelsína
apgengi	aðgengi
apilsina	pilsinu;appelsína
aplauni	apaungi;aflraunir
aplisafi	eplasafi
apötek	apótek
apoteki	apóteki
apotekið	apótekið
apotekin	apótekin
apotekina	apótekinu
apótekina	apótekinu
apótheki	apóteki
appels	uppelst;Annels;appelsína
appelsin	appelsín
appelsina	appelsína
appélsina	appelsína
appelsínasafa	appelsínusafa
appelsinasafi	appelsínusafi
appelsínasafi	appelsínusafi
appelsingular	appelsínugular
appelsingulur	appelsínugulur
appelsínugluur	appelsínugulur
appelsinugúlur	appelsínugulur
appelsinur	appelsínur
appelsinúr	appelsínur
appélsinur	appelsínur
appelsínurgul	appelsínugul
appelsinusafi	appelsínusafi
appelsínusafu	appelsínusafi
appelssina	appelsína
appeslínu	appelsínu
applesínu	appelsínu
applesínur	appelsínur
appzlsína	appelsína
aprí	apríl
aprík	apríl
april	apríl
apstoða	aðstoða
aptíum	partíum
aptr	apar;aftur
apúðar	púðar
aŕ	að;ár
arab	araba;Araba
arabisk	arabísk
áræðanlegur	áreiðanlegur
aræmu	ræmu
arangur	árangur
arangursrými	farangursrými
aransonar	Arasonar;Aronssonar
ararinn	arinn;Þórarinn
ararn	arann
arás	árás
áras	árás
arbaer	arabar;Arabar
arbeyga	arneyga;armbeygja
arbeyja	arneyga;armbeygja
arbnar	arnar;arabana;Arabana
arðra	aðra
areiðanleur	áreiðanlegur
arekstar	árekstrar
arendi	sendi;Aurendi
ares	Ares
aresera	rasera
arfærin	varfærin
arfasáti	arfasátu
arfek	afrek
arfík	Afríka;Afríku;traffík
arﬂeið	arfleifð;leið;reið
arfleiðar	arfleifðar
arganns	argaðs;fargans
argans	fargans;agans;argaðs
argentía	Argentína
argentina	Argentína
argentinskur	argentínskur
argetískur	argentínskur
argrímsson	Arngrímsson
argue	argur
argus	angus;argur
aríaðna	Aríana
ariel	Aríel
arinbjörrn	Arinbjörn
arj	Ari
arjan	argan
arjóður	sjóður;rjóður
arkefí	skef
arkítektur	arkitektar;arkitektúr
arkon	Aron
armbandsúurin	armbandsúrin
armbeiga	armbeygja
armbeija	armbeygja
armdís	Arndís
armists	armasts
armlaus	arflaus
armsband	armband
armue	armur
arnahól	Arnarhól
arnason	Arnarson
arnast	annast
arnastofun	Árnastofnun
arngrimur	Arngrímur
arnjótur	Arnljótur
arnljotur	Arnljótur
arnlótur	Arnljótur
arnnarri	annarri
arnólfur	Örnólfur
arnþráður	Arnþrúður
arnþruður	Arnþrúður
arór	Arnór;órar
arsímann	farsímann
arsti	Ari
arstid	Astrid;árstíð
arstið	arið;árstíð
árstið	árstíð
árt	ár
arteria	tería
artería	tería
artöl	ártöl
arts	Artúrs;arta;art
artþ	art
arvarlegur	alvarlegur
arvu	aríu
ary	Ari
as	ás;asi
asað	ansað
asáð	sáð;allsgáð
asaðari	austari;dasaðri
asbjörn	Ásbjörn
ásdis	Ásdís
asðstæður	aðstæður
aseran	serían
aséran	sérann
asfasf	aspas
asfkur	askur
asgrímur	Ásgrímur
askavaðandi	askvaðandi
askemmtilegar	skemmtilegar
aslauni	launi
asleiðing	afleiðing
aslf	alfa
asmaða	asmað
asmaði	amaði;asmað
asmaðs	asmað
asmaðu	asmað
asnið	snið
asólarströnd	sólarströnd
aspes	spes;aspas
a­spjöll	spjöll
assist	massist
asskotin	asskotinn;asskoti
asstmi	astma
assýrskur	assýrískur
astæda	ástæða
astarhug	ástarhug
asteignasolunni	fasteignasölunni
astfanginn	ástfanginn
asthma	astma
astís	Ásdís
astófa	stofa
astralía	Ástralía
astróp	skróp
astros	Ástrós
ástrós	Ástrós
asty	kasti
astyr	styr
asuturstræti	Austurstræti
asýla	sýla
asylgjunni	sylgjunni
atafla	tafla
atall	stall
atapil	gatabil
atari	altari
atbúrð	atburð
atburðaás	atburðarás
atbúrðarás	atburðarás
atburðarríkur	atburðaríkur
atbúrðir	atburðir
atbúrðurin	atburðurinn
atbúrðurinn	atburðurinn
atelur	telur
atggervi	atgervi
athæfur	athæfi
athafast	aðhafast
athafnarkona	athafnakona
athafnur	athafnir
athagana	athugana
athburð	atburð
athending	afhending
athendingu	afhendingu
athhyglisvert	athyglisvert
athigly	athygli
athöf	athöfn
at­huga­	athuga
athugas-m	athugasöm
athugasamdir	athugasemdir
athugasemdi	athugasemdir
athugasemðir	athugasemdir
at­hugsa	athuga
athugulun	athugulum
athuguml	athugul
athugumþ	athugum
athyglisjúkur	athyglissjúkur
athyglj	athygli
atilla	stilla
atiss	atist
atkaur	ataður
atkvæðimesti	atkvæðamesti
atlagi	atlaga
atlandshaf	Atlantshaf
atlants	Atlanta
atlantus	Atlanta
atlatla	Atlanta
atofa	stofa
atofngerð	stofngerð
atogi	togi
atök	átök
atóljóð	atómljóð
atólljóð	atómljóð
atólmljóð	atómljóð
atonni	tonni
atormur	stormur
atórt	stórt
atrætó	strætó
atraujárn	straujárn
atrenu	atrennu
atriåi	atriði
atriðsins	atriðisins
atrii	atriði
atrýni	trýni
atsegir	afsegir
atslag	afslag
attað	áttað
attan	aftan
attgent	ættgengt
atthygli	athygli
áttján	átján
attriði	atriði
attu	áttu
áttugasti	átttugasti
attur	aftur
atughun	athugun
atuttur	stuttur
atvík	atvik
atvikorð	atviksorð
atvinnleysi	atvinnuleysi
atvinnu·laus	atvinnulaus
atvinnuaus	atvinnulaus
atvinnuhúsæði	atvinnuhúsnæði
atvinnuleysisbót	atvinnuleysisbóta
atvinnuleysistryggingargjald	atvinnuleysistryggingagjald
atvinnumenska	atvinnumennska
atvinnureikanda	atvinnurekanda
atvinnureikandi	atvinnurekandi
atvinnureikenda	atvinnurekenda
atvinnusbætur	atvinnubætur
at­vinnu­við­tal	atvinnuviðtal
atystan	stystan
au	að
áu	áttu;á
auasa	ausa
auðelt	auðvelt
auðfela	auðvelda
auðgara	nauðgara
auðigr	auðir;auðugur
auðigur	auðugur
auðil	auði
auðiur	auður
auðka	auka;auðga
audkenna	auðkenna
auðkennig	auðkenning
auðleærð	auðlærð
auðlegp	auðleg
auðlerður	auðlærður
auðljóst	augljóst
auðlveldur	auðveldur
auðmatti	auðmanni
auðmjúkleg	auðmjúklega;auðmjúk
auðmjúklegur	auðmjúkur;auðmjúklega
auðmjúlegur	auðmjúkur
auðnari	auðnar
auðnis	auðnist
auðnn	Auðunn;auðn
auðns	Auðuns
audorf	Adolf
auðr	auður;Auður
auðssöfnun	auðsöfnun
auðssvi	auðnarsvip
auðúlfur	rauðúlfur
audunn	Auðunn
auðunns	Auðuns
auðunnson	Auðunsson
auðunnsson	Auðunsson
auđur	auður;Auður
auðveæt	auðvelt
auðveðari	auðvæðari
auðveik	dauðveik
auðveikra	dauðveikra
auðveikur	dauðveikur
auðvel	auðvelt
audveld	auðveld
audvelð	auðveld
audveldara	auðveldara
audveldari	auðveldari
auðvelðdur	auðveldur
auðveldro	auðveldri
auðveldun	auðveldur
audveldur	auðveldur
auðvelður	auðveldur
auðvelfur	auðveldur
auðvelgur	auðveldur
auðvelk	auðvelt
auðvelkra	auðveldra
auðvelldur	auðveldur
auðveltlega	auðveldlega
auðveltur	auðveldur
auðvitatt	auðvitað
auðvitut	auðvituð
auðvyeltlega	auðveldlega
auðyr	auður
aufari	daufari
aufem	aum
aufln	öflun
aufundar	öfundar
aufusugestur	aufúsugestur
aug	auga;auk;taug
aúga	auga
augabrú	augabrún
augabrúir	augabrúnir
augabrúm	augabrún;augabrúnum
augabrun	augabrún
augabrúr	augabrún;augabrýr;augabrúnir
augabrýn	augabrýr;augabrún;augabrúnir
augahár	augnhár
augalega	aukalega
augalið	augaleið
augalíð	augaleið
augamið	augnamið
augandi	auðgandi
auganhár	augnhár
auganna	augnanna
augasta	augastað
augbrun	augabrún
augðan	auðan;áðan
augðann	agðann;áðan
augdropa	augndropa
augir	dugir;auðir
auglandi	ruglandi
auglið	auglit
auglíð	aulið
auglitis	augliti
augljósur	augljós
auglok	augnlok
auglúsinguna	auglýsinguna
auglýsar	auglýsir;auglýsa
auglysingu	auglýsingu
auglýsingur	auglýsingar
auglýsongar	auglýsingar
augnablíkið	augnablikið
augnabrú	augnabrún
augnabrúm	augnabrúnum
augnafagr	augnafagri
augnag	augna
augnarbrú	augnabrún
augnasamband	augnsamband
augnbrún	augnabrún;augabrún
augnbruna	augnabrúna;augabrúna
augnbrúna	augnabrúna
augnbrúnalenging	augabrúnalenging
augnbrýr	augnabrýr
augnhátabrettari	augnhárabrettari
augniblik	augnablik
augnkarl	augnakarl
augnlíð	augnglóð
augnsamaband	augnsamband
augntillit	augnatillit
augp	augu
augri	auri
augslum	augum
augsmyrsl	augnsmyrsl
augsmyrsli	augnsmyrsli
augstlum	austrum
augstum	augum
augsýni	augsýn
augt	augu
auguabrúni	augabrúnir
auguabrúnir	augabrúnir
augubrun	augabrún
augubrúni	augabrúnir
augubrúnir	augabrúnir
auha	auka;auga
auhugaverð	athugaverð
aúhugaverð	athugaverð;áhugaverð
aui	auki;auli
auir	aukir
aukaæ	auka
aukað	auka;aukið
aukaför	aukaförg
aukahlurir	aukahlutir
aukan	auka
aukandar	aukandi
aukastr	aukast
aukatriði	aukaatriði
aukaverkur	aukaverkun
aukhurð	aukahurð
aukiat	aukist
aukinat	aukinna;aukist
aukininn	aukinn
aukinns	aukins
aukn	aukin
auknist	aukist
auknunn	aukning;auknum
aukrast	aukast
auks	auk;hauks;lauks;bauks
auksins	aukins;hauksins;bauksins;lauksins
aukst	aukist;aukast
aukstur	akstur
aukt	auktu
auktur	auktu
auku	auki
aukur	haukur;Haukur;laukur;baukur
aukvað	aumkvað;eitthvað
aulagildur	aulagildrur
aulanu	aulanum
aulará	aular
aularáð	auraráð
aulasta	aulast
aulgóðan	algóðan
aull	sull;auli
ault	sult
aulýsir	auglýsir
aumað	amað
aumgóðan	taumgóðan
aumingo	aumingi
aumingur	aumingi
aumknunn	aumkunin
aumkr	aumkar
aumkunn	aumkun
aumkunna	aumkunina;aumkun
aumkunnarvert	aumkunarvert
aumkunnavert	aumkunarvert
aumkvun	aumkun
aumundan	aumlyndan
aun	aum
aungri	ungri;angri
aunýr	nýr
aupair	kaupir
aupit	kaupin
auranir	aurarnir
aurasti	auri
aurastir	aumastir
aurim	aurum
aursafn	aurasafn
aurstadæmin	furstadæmin
auru	aurum
aurug	auðug
aurugar	saurugar
aurv	aur
ausað	ausið
ausauka	auðsgauka
ausdu	austu
ausig	ausið
austaríki	Austurríki
austarriki	Austurríki
austarríki	Austurríki
auster	austur;austar
austeríki	austverki;Austurríki
austfirkur	austfirskur
austfiskur	austfirskur
aústralía	Ástralía
aústralíu	Ástralíu
austría	austra
austurí	austur;Austurríki
austuriki	Austurríki
austuríki	Austurríki
austuríkir	austurrískir;Austurríki
austurísku	austurrísku
austurríkum	austurrískum
austurrríki	Austurríki
austurrún	austurbrún
austurrýki	Austurríki
austurstræri	Austurstræti
austurströndi	austurströndin
ausuð	ausið
ausýn	augsýn
ausýni	auðsýni
auta	aura
aútkoma	útkoma
auttar	attar;utar;aftar
autti	autt;átti
auttir	attir;áttir
auttist	kuttist;áttist
auu	augu
auvirðuilegur	auvirðilegur
auvirðulegur	auvirðilegur
ava	afa
avacadó	avókadó
avakódó	avókadó
avalda	valda
avana	ávana
avar	var
avarpa	ávarpa
avaxtakörfu	ávaxtakörfu
avaxti	ávaxti;ávexti
avaxtur	ávöxtur;ávaxtir
avðentukrans	aðventukrans
avé	vé
aveg	alveg
áverkur	áverkar
avetir	veitir
avextir	ávextir
aviða	viða
avík	vík
avíntýri	ævintýri
avíntýrið	ævintýrið
avitur	vitur
avo	svo
avokad	avókadó
avokado	avókadó
avokadó	avókadó
avókado	avókadó
avoxtur	ávöxtur
ávoxtur	ávöxtur
avr	var
axá	laxá
axal	axel
axár	laxár
axarfirði	Öxarfirði
axarfjörður	Öxarfjörður
axari	axar
axarskapt	axarskaft
axarþes	axarnes
axas	axa
axcel	Axel
axek	Axel
axekl	Axel
axex	Axel
axillum	foxillum
axillur	allur;foxillur
axl	axla
axlan	axla
axlarnir	jaxlarnir;axlirnar
axlirs	axlir
axnar	asnar
axst	saxast
axun	oxun
axuna	sexuna
ayanna	augnanna
aygna	augna
ayra	aura
aysa	ausa
azerbaijaníska	aserska;Aserbaídsjan
aþingi	alþingi;Alþingi
aþols	óþols;þols
aþrenna	þrenna;atrenna
b ùok,enntu,	bókmenntir
b;ndur	bændur;bindur
b;r	býr;búr
b;ta	bæta;bíta;bóta
b.frestinum	frestinum
b.viðar	viðar;Viðar
b.viðmiðunar	viðmiðunar
b´0k	bök;bók
b´kasafnið	bókasafnið
b´kmenntir	bókmenntir
b´kur	bækur
b´ta	bæta;bíta;báta
b´z	bs
b~ill	bíll
b0rn	börn
ba	búa;bað;bar;vá;ná;bæ
bá	á
ba r n	barn
baaldur	Baldur
baátta	barátta
bababi	babbi
babar	bablar
babtterý	batterí
bach	bak
backpoka	bakpoka
backpokar	bakpokar
backpoki	bakpoki
bacon	búason;beikon
bad	bað
báð	bað;báðu
bađa	baða
báðan	báða
baðherberge	baðherbergi
baðherberggi	baðherbergi
baðherbigið	baðherbergið
báði	báðir;bæði
báðið	baðið
báðier	báðir
bàðir	báðir
baðja	biðja
baðk	bak;baðkar
báðloppa	baðsloppa
báðloppur	baðsloppur
baðlu	baulu
báðm	báðum
badmínton	badminton
báðri	báðir
baðsa	baðsalt
baðset	baðst;baðsett
badst	baðst
badstrond	baðströnd
badströnd	baðströnd
baðtu	baðstu
bádu	báðu
báðue	báðu;báðir
baðum	báðum
báður	báðir;báðum;Bárður
báðusts	báðust
baðvörur	baðvörður
bæaði	bæði
bæar	bæjar
bæár	bær
bæatur	bætur
bæbi	bæi;bæni
bæð	bæði;hæð
bæða	bæði;bræða
bæddist	fæddist;bætist
bædi	bæði
bædist	bætist
bæðoi	bæði
bæðou	bæðu
bæðui	bæði
bædurna	bændurna
bægs	bæs
bæil	bil
bæilum	bælum;bilum
bæin	bæinn
bæín	bæn
bæio	bæi
bæis	bæi
bæjarbúm	bæjarbúum
bæjatins	bæjarins
bæjga	bæja;bægja
bæji	bæi
bæjir	bæir
bæjirnir	bæirnir
bæjn	bæn;bæinn
bæjr	bær;bæir;bæjar
bæjur	bæjar;bæir
bæklinur	bæklingur
bælsti	bæli;bældasti;bælist
bælu	bæli
bælva	bæla;bölva
bælvaður	bölvaður
bælvum	bælum
bæm	bæ;bæjum
bænað	bæna
bænafórn	bænarfórn
bænargjörð	bænagjörð
bænatl	bænatal
baenda	bænda
bændana	bændanna
bændasamfélagur	bændasamfélagi
bændr	bændur
bænr	bæn;bænir
bæný	bæn
bæonda	bænda
bæraða	bærða
bærfallegur	blæfallegur
bærg	berg;borg
bærnir	birnir;bornir
bærslina	færsluna
bærur	bætur
bæsinns	bæsinn;bæsisins
bætiflákiný	bætiflákinn
bættis	bættist
bættst	bættist;bæst
bæunir	baunir;bænir
bæxar	bæjar
bæyr	bær
baf	af;bar
bafn	jafn;barn
bagars	bagar
baggr	bagg
báhillur	bábiljur
báir	báðir
bäita	bita
bák	bak
bakanir	bókanir
bakann	bakan
bakar´ð	bakgarð;bakaríið
bakarì	bakarí
bakariđ	bakari;bakaríið
bakaríð	bakaríið
bakariid	bakaríið
bakariið	bakaríið
bakariíð	bakaríið
bakaríid	bakaríið
bakaríiđ	bakaríið
bakarííd	bakaríið
bakarííð	bakaríið
bakariinu	bakaríinu
bakarinu	bakaríinu
bakarìsins	bakarísins
bakarlið	bakaríið
bakboki	bakpoki
bakerí	bakarí
bakfæði	bakfærði;bakflæði
bakgrunna	bakgrunn
bakgrunnuri	bakgrunnur
bakgrunnut	bakgrunnur
bakimu	bakinu
bakin	baki
bakina	bókina
bakkal	bakka
bakkava	bakkana
bakkelsa	bakkelsi
bakkin	bakkinn
baklega	bóklega
bakon	beikon
bakrunnsspurningar	bakgrunnsspurningar
baksl	basl
bakslagar	bakslagi
bakstrik	bakstri
baksturofn	bakstursofn
bakteri	baktería
bakteria	baktería
baktús	baklús;baktus
balad	bálað
balædur	Baldur
báld	bál
baldakinn	baldskinn
baldakyn	baldakinu
baldi	valdi;Valdi;Baldri
baldlur	Baldur
baldue	Baldur
baldunn	baldinn;Baldvin
báldur	Baldur
baldur.	Baldur
baldurö	Baldur
baldvib	Baldvin
baldyr	Baldur
bálkostur	bálköstur
bálkr	bálkur
ballad	balla;ballaða
ballað	balla;ballaða
ballð	ballið;balla;ballaða
ballet	ballett
balletur	ballett
ballöða	ballaða
ballskjól	ballkjól
bálnaði	bálaði
bálnum	bálum;bálunum
bálp	bál
balsma	basma
bálsma	bása
balstan	balsann
balstram	bólstrum
balt	valt
baltasar	Baltasar
baltisk	baltísk
balut	blaut
bálv	bál
balveiki	bílveiki
bambaríska	barbaríska;bandaríska
bamdaríku	bandarísku
bamkann	bankann
baml	braml
banan	banani;banann;bananann
bananabrau	bananabrauð
bananaum	banananum
bananio	banani
bananu	banana;banani
banbus	bambus
banda·ríkin	Bandaríkin;bandaríkin
bandarí	bandaríki;brandari
bandaríakamaður	Bandaríkjamaður
bandarík	bandarísk;Bandaríkin;bandaríkin
bandarika	bandaríska
bandaríkamaður	Bandaríkjamaður
bandarikan	bandarískan;bandaríkja
bandaríkan	bandaríkja;Bandaríkjanna
bandarikin	Bandaríkin;bandaríkin
bandaríkinn	Bandaríkin;bandaríkin
bandaríkir	bandaríki;Bandaríkin
bandarikj	bandaríkja;Bandaríkin
bandaríkjana	Bandaríkjanna;bandaríkjanna
bandarikjanna	Bandaríkjanna;bandaríkjanna
bandarikjum	bandaríkjum;Bandaríkjunum
bandaríkjunu	bandaríkjunum;Bandaríkjunum
bandarikjunum	bandaríkjunum;Bandaríkjunum
bandaríkjur	bandaríkjum
bandaríkssur	bandarískur
bandaríksur	bandarískur
bandarinn	brandarinn
bandariska	bandaríska
bandarísksur	bandarískur
bandarisku	bandarísku
bandariskur	bandarískur
bandariskúr	bandarískur
banðr	banar
bandsslitun	bandslitur
banður	bannaður
bangsirb	bangsir;bangsi;bangsar
bangsirk	bangsir;bangsi;bangsar
bangsirn	bangsinn
bangsirt	bangsir;bangsi
baní	bani
banin	baninn
bánk	bank
bánka	banka
bankaðin	bankaði
bankam	banka;bankann
bankan	bankann
bankanm	bankann
bankare	bankar
bankarei	bankari;bankareikningur
bankareik	bankareikning
bankareikn	bankareikning
bankareikni	bankareikning
bankareining	bankareikning
bankaríkin	Bandaríkin;bandaríkin
bankaríkjunum	bandaríkjunum;Bandaríkjunum
bankaupplýsing	bankauplýsingar
bankaupplýsinga	bankaupplýsingin;bankaupplýsingar
bankaupplýsingin	bankaupplýsingin;bankaupplýsingar
bankí	banki
bankibú	bankabú
bankin	bankinn
bankio	banki
bankiu	banki
banksi	banki
bannað🔞	bannað
bannai	banna
bannan	annan
bannana	banana
bannanda	bannandi
bannani	banani
bannins	bannsins
bannmerking	bannmerki
bannn	bann
bannr	bann
bannst	fannst;vannst
bannur	bannar;bannir
bannvænn	banvænn
bannvænt	banvænt
banr	barn
bansettur	bannsettur
bánsi	bási;bangsi
banstutt	andstutt
banur	vanur
bápir	báðir
bappi	vappi;pabbi
baptise	baptista
baraítón	baríton;baritón
baráta	barátta
barátat	barátta
barátt	baráttu;barátta
bárattu	báróttu;baráttu
barb	barn
bard	barð
barda	bara;barða
bardag	bardaga
barðaga	bardaga
bardagagur	bardagaguð
barðagamaður	bardagamaður
bardagan	bardagann
barðaginn	bardaginn
bardagur	bardagar;bardagi
bárðar	báðar;bárðar
barðarstór	barðastór
barđastór	barðastór
barðdt	barðist
bardegi	bardagi
barðie	barði;barðir
barðstór	barðastór
bárdur	bárður
bare	bara;barr;bar
bargada	bjargaða
bari4	bari;barir
barintón	baritón
bariton	bariton;baritón
baritónn	barinn;baritón
barkakúli	barkakýli
barkari	bakari
barkarí	bakarí
barkasöngur	barkaslöngur
barkstera	bakstra
barnabækar	barnabækur
barnæskja	barnæska
barnafita	barnafata
barnafóstru	barnfóstru
barnaheimil	barnaheimili
barnalaug	barnalög
barnaldri	barnsaldri
barnasaáttamálinn	barnasáttmálinn
barnaskair	barnaskari
barnbarn	barnabarn
barnd	barn
barndagann	bardagann
barndn	barinn;barn
barneignarferli	barneignarferli;barneignaferli
barnfaðir	barnfaðir;barnsfaðir
barnfóstrun	barnfóstruna;barnfóstru
barnfróstra	barnfóstra
barninju	barninu
barnsadlit	barnsandlit
barnvænlegt	banvænlegt;barnvænt
baronsstigur	Barónsstígur
baronsstígur	barónsstígur
barónsstigur	Barónsstígur
barónstíg	Barónsstíg
barónstigur	Barónsstígur
barótta	barátta
barraddur	barraður
barrmerki	barmmerki
barrnsins	barnsins
barsími	farsími
barströnd	baðströnd
baruð	bauð;brauð;varúð
bàrur	bárur
bár­ust	bárust
barw	bar
basillika	basillika;basilíka
basin	basinn
basinna	basinn
bask	bak;brask
basnar	asnar
bást	bát;ást
bastsa	bassa
básúba	básúna
bataðari	bataðri
bátae	báta;bátar
bátakveðjur	batakveðjur
batan	batann
batarkveðjur	batakveðjur
bátarkveðjur	batakveðjur
bátaur	bátar
bathi	bati
bathoníum	Baþóníu
batnakveðja	batakveðja
batnakveðjur	batakveðjur
batra	bata
bátsið	básið
bátsuð	básuð
batte´ri	batterí
batterý	batterí
batteryslaus	batteríslaus
batunum	bátunum
báturr	bátur
bäua	búa
baud	bauð
bauði	brauði
bauðs	brauðs
bauf	bauð;baug
baufa	daufa
baugaðu	baukaðu
baugfingu	baugfingur
baugja	bauga
baugu	bauju;baug
baugun	bugun;augun
baukaru	baukarðu
baukin	baukinn
bauknir	baunir
baulast	baula
baulist	baunist
baum	baun
baúnir	baunir
baunk	bank
baunkum	bönkum
bauns	bauna
baunu	baunum
báur	bátur
baurg	baug
bautan	bautann;blautan
bautt	blautt
bávagns	ávans
bavian	bavían;bavíani
bavián	bavían;bavíani
báxa	báða;bása
baxið	baksið
baxir	baksir
baxl	baks
baxlið	baksið
bbaka	baka
bbbbóndi	bóndi
bbrosa	brosa
bbúa	búa
bbutansku	bútönsku
bbyrja	byrja
bdnti	benti
bðrn	börn
bðrnin	börnin
be	ber
béaa	béaða
beægur	bergur
bear	ber
beauty	beötu
becky	beskyn
béð	beð
béða	beða
beðann	beðinn
beðiom	beðum
beðma	beðmi
beðq	beð
bedt	best
bee	ber
beesku	bernsku
bef	ef;ber
befjað	befrað;nefjað
bega	mega
begar	vegar
begði	beygði
begg	vegg
begja	beggja;beygja
begs	bergs;vegs
begu	vegu
begyja	beygja
bei	bein
beicon	beikon
beiconi	beikoni
beíð	beið
beiddast	beiddist;beittast
beiððni	beiðni
beiðja	biðja
beidn	bein;beinn
beiðn	beiðni
beiðnabrbók	beiðnabók
beige	beygi
beiging	beyging
beigja	beygja
beigjing	beyging
beigla	beygla
beiglu	beyglu
beigs	beygja
beigu	beygju
beija	beygja
beiju	beygju
beik	veik
beikið	veikið
beikka	breikka
beikun	beikon
beilti	belti
beimill	heimill
beinaæxli	beinæxli
beinði	beindi
beingá	beiná
beingrind	beinagrind
beinkrum	beinkröm
beinlýnis	beinlínis
beinnti	beinni;beindi
beinskeittur	beinskeyttur
beinskeytni	beinskeyti
beintu	beindu
beinund	einund
beinverkur	beinverkir
beisikk	beisk
beisin	beysin
beisksur	beiskur
beistli	beisli
beitabóndi	geitabóndi
beitarbóndi	geitabóndi
beiteins	Beinteins
beitingarland	beitiland;beitarland
beitiskúr	beituskúr
beiuta	beita
bejkur	bekkur
bekać	bekan
bekingur	ábekingur;bekkingur
bekja	bekkja;vekja
bekkabróður	bakkabróður
bekkar	bekkjar
bekkasystkin	bekkjarsystkin
bekkjabróður	bekkjarbróður
bekkjafélaga	bekkjarfélaga
bekkjarbsyskinum	bekkjarsystkinum
bekkjarfélagur	bekkjarfélagar
bekkjarríja	bekkjarýja
bekkjarsyskyn	bekkjarsystkin
bekkjarsyskyni	bekkjarsystkini
bekkjarsyskynum	bekkjarsystkinum
bekkjarsystk	bekkjarsystir
bekkjarsystkyn	bekkjarsystkin
bekkjarýa	bekkjarýja
bekkjasáttmáli	bekkjarsáttmáli
bekkjasystir	bekkjarsystir
bekkjasystkin	bekkjarsystkin
bekkjasystkini	bekkjarsystkini
bekkjasystur	bekkjarsystur
bekkjur	bekkur
bekklingur	bekkingar;bæklingur
bekkuna	brekkuna
bekkut	bekkur
beknum	bekknum
bekur	bækur;dekur;vekur
belgia	Belgía
belgìa	Belgía
belgís	belgísk
belgisk	belgísk
belgiska	belgíska
belgiubelgíska	Belgíu;belgíska
belgíum	Belgíu
belgpípetta	belgpípna
belkur	spelkur
belo	bel
belsku	elsku
belssaðan	blessaðan
belssaðann	blessaðan
belssun	blessun
belt	belti
beltbeltið	eldbeltið;beltið
beltinn	beltin
beltínn	belginn;beltin;Belginn
beltun	beltin
belu	bellu
bén	ben
bendlun	bendlum
bendurs	bendur
benedik	Benedikt
benedikdikt	Benedikt
benedikr	Benedikt
benedíkt	Benedikt
benedit	Benedikt
beneditkt	Benedikt
benet	bent;Bent
benetikt	Benedikt
beng	bent;Bent
bengs	bergs
bengt	bent;Bent
benit	beint;bent;Bent
benjamæín	Benjamín
benjamin	Benjamín
benjamín	Benjamín
benjamins	Benjamíns
benju	venju
bennsli.	rennsli;bensli
benoní	Benoný
benonís	Benonýs
benonísdóttir	Benonýsdóttir
bensinstod	bensínstöð
bensínstoð	bensínstöð
bensínstöd	bensínstöð
bensínstöði	bensínstöðin
bensinþjófi	bensínþjófi
bensístöð	bensínstöð
beotin	brotin
beppur	leppur
bepu	betu
berfa	bera
berfað	bera
bergamía	gambía
bergandi	bergjandi
bergat	gat
bergð	bergið
berge	berg
bergfilla	bergfylla
berglibd	Berglind
bergliind	Berglind
berglínd	Berglind
bergljó	Bergljót
bergljólt	Bergljót
bergljótlaufey	Bergljót;laufey
berglnd	Berglind
berglót	Bergljót
bergmal	bergmál
bergson	Bergsson
bergstangi	bergtangi
berguna	bergruna
berjað	berja
berjandisk	berjandi
berjar	berja;byrjar
berjat	berjast
berkastar	berktastar
berkið	bergið
berkjun	berkjuna
berkjungar	berkjunnar
berlim	Berlín
berlin	Berlín
berlínar	Berlínar;Berglínar
berlirnar	berlingar;Berlínar;Berglínar
bermann	Bergmann
berran	beran
berrasaður	berrassaður
bersaðu	berstu
bersta	besta
berstur	bestur
bersýn	bersýni
bersýnlega	bersýnilega
bersýnn	bersýnin;bersýnilegur
bersýnt	bersýnilegur
berunesshreppur	Beruneshreppur
beryja	berja
bes	bers
besenis	bensens;vesenis
bessað	blessað
bessaðar	blessaðar
bessastöðu	Bessastöðum
bessiv	bessi;Bessi
best<	best
beste	besta
besteinn	bergsteinn;Bergsteinn
bestit	besti
bestka	besta
bestq	best
bestue	bestu
beterar	betrar
betgður	begður
betlara,	betlara
betlehemstjarna	betlehemsstjarna
bétri	betri
betrumbætq	betrumbæt;betrumbæta
bets	best
betsy	besti
better	bitter
betterar	beittrar
bettri	betri
beuging	beyging
beutr	betur
bevill	berill
beyga	beygja
beygast	beygjast
beygðann	beygðan
beygingalýsing	beygingarlýsing
beygingunni.	beygingunni
beygj	beygja
beygya	beygja
beygying	beyging
beygyng	beyging
beyia	beyla
beying	beyging
beyíngar	beygingar
beyja	beygja
beyjgja	beygja
beyji	beygi
beyn	bein
beysk	beisk
beyskinn	beysinn
beysli	beisli
beysnati	beysnasti
beyt	beit
beyta	beita
beytti	beitti
beyttu	beittu
bezta	besta
bezti	besti
beztr	bestir
bfimill	brimill
bgoð	boð
bguðmundur	Guðmundur
bháll	háll;páll;Páll
bhartur	bjartur
bhilíska	balíska
bi	bí;bú
bi]ja	biðja
bi∂a	bita
bíæl	bíl
bianka	banka
bibblía	biblía;Biblía
biblískur	biblíur
bíbtest	bítast;píptest
biđ	bið
bíd	bíð
bíđ	bíð
bið1ja	biðja
bida	binda;bíða
biđa	bíða
bída	bíða
bíđa	bíða
bìða	bíða
biðatima	biðtíma
biðatíma	biðtíma
biðbænum	miðbænum
biðbær	miðbær
biðbætur	viðbætur
biðbót	viðbót
bidda	budda
bídda	bíddu
bíðða	bíða
biðdja	biðja
bíððu	bíaðu
biðður	biður
bídet	býðst
bíðet	Bríet
bídi	bíði
biðikolla	biðukolla
bidja	biðja
biďja	biðja
biđja	biðja
bíðja	biðja;bíða
bidjað	biðjið
bidjaðu	fitjaðu;biddu
biðjs	biðja
bíðjum	biðjum
biðlána	biðlana
bíðlisti	biðlisti
biðlumst	biðjumst
biðnu	birnu
bíðst	býðst
biđum	biðum
biđur	biður
bíđur	bíður
bíður.	bíður
bient	beint
bientt	beint
bietnam	bitnum
bífra	bifra
bifrei	bifreið
bifreiðasali	bifreiðasala
bifreiðastöðiur	bifreiðastöður
bifreiðastöðr	bifreiðastöður
bifreiðini	bifreiðinni
bifrost	bifröst;Bifröst
bifrosy	bifröst;Bifröst
bífur	býfur
bifurkolla	bifukolla;biðukolla
bífvélarvirki	bifvélavirki
bífvelavirki	bifvélavirki
bifvélavirkin	bifvélavirkinn
big	bug;bið
bíg	bít;bí
bígað	bíað
bígaðu	bíaðu
biggðu	byggðu
biggður	byggður
bíginna	boginna
bigir	birgir
bíí	bíó;bíl;bí
bíibliu	biblíu;Biblíu
bíímynd	bíómynd
bíita	bíta
bíjörðum	bújörðum
bikarkepnni	bikarkeppni
bikasvarrur	biksvartur
bikasvartur	biksvartur
bike	biki
bíkingur	víkingur;Víkingur
bikyaska	birkiaska
bilađ	bilað
bíladur	bílaður;bilaður
bílaflaut	bílflaut
bílaflauta	bílflauta
bílagreina	bílgreina
bílakjallaran	bílakjallara;bílakjallarann
bilaleiga	bílaleiga
bílaleigubila	bílaleigubíla
bílaleigubilinn	bílaleigubílinn
bilama	bilana
bílamerki	bílmerki
bílap	bíla
bílaprófið	bílprófið
bilarirnar	bilanirnar
bilarnir	bílarnir
bílastæð	bílastæði
bílastædi	bílastæði
bilaþvottur	bílaþvottur
bild	bil
bildudalur	bíldudalur
bilett	blett
bilfreið	bifreið
bílin	bílinn
bïliskúr	bílskúr
biljarðsstofa	billjarðsstofa
biljarðstofa	billjarðstofa
bílk	bíll
bílkúr	bílskúr
bill	bíll
bíĺl	bíl;bíll
billaður	bilaður
bíllhjólabretti	bíll;hjólabretti
bílli	bíll
billin	bilin;bíllinn
bíllin	bíllinn
billinn	bíllinn
bìllinn	bíllinn
billion	bilin
billión	billjón
bíllli	bílpalli;bíll
bílllinn	bíllinn
bíllnum	bílnum
bíllstjori	bílstjóri
bíllstjóri	bílstjóri
bíllum	bílum
bíllur	bíll
bílm	bílum
bilnum	bílnum
bílrafgeymir	bílarafgeymir
bílrúðunar	bílrúðurnar
bilsinu	bilinu
bílskór	bílskúr
bilskúr	bílskúr
bílskurinn	bílskúrinn
bílskúrn	bílskúr
bilslys	bílslys
bìlslys	bílslys
bilsma	bilana
bílsskúr	bílskúr
bílstæði	bílastæði
bilstjór	bílstjóri
bilstjórana	bílstjórana
bilstjóranna	bílstjóranna
bilstjori	bílstjóri
bílstjori	bílstjóri
bílstjórin	bílstjórinn
bilstkúr	bílskúr
bílstkúr	bílskúr
biltinguna	byltinguna
bíltur	bíltúr
bíltút	bíltúr
bílúð	bíluð;biluð
biluns	bilun
bílúr	bíltúr
bílyklar	bíllyklar
bílyúr	bíltúr
biml	bil
bimsa	bisa
bímynd	bíómynd
bin	sín
bín	sín;bón
binð	bið
bíndabæ	bóndabæ
bindingsverkhús	bindingsverkshús
bíngaði	bungaði
binkjarni	borkjarni
binnans	finnans
binsanna	bisanna
binzk	bank
bio	bíó;bil;bo
bió	bíó
bío	bíó;bíl
bìó	bíó
bióm	blóm
bíómið	bíómiði
biomiða	bíómiða
biómiða	bíómiða
bíómybd	bíómynd
biomynd	bíómynd
bíomynd	bíómynd
bíómynð	bíómynd
bíömynð	bíómynd
bíómynd.	bíómynd
biómyndar	bíómyndar
biomyndin	bíómyndin
biomyndina	bíómyndina
bíómyndinar	bíómyndirnar
biomyndir	bíómyndir
biomyndirnar	bíómyndirnar
bíomynf	bíómynd
bíómynf	bíómynd
bíótónlisy	bíótónlist
bípaðu	bíaðu
bírani	Írani
birð	borð
birða	borða
birði	byrði
birðinu	borðinu
birðja	biðja
bireiðastöðr	bifreiðastöður
birgðarstöðu	birgðastöð
birger	birgir
birghir	birgir
birgitte	birgitta
birgpir	birgir
birgr	birgir
birigr	birgir
birja	byrja
bírja	byrja
birjaði	byrjaði
birjaður	byrjaður
birjuðu	byrjuðu
birjum	byrjum
birkils	birkis
birkirs	birkir
birma	birna;Birna
bírn	börn
birnaída	barnaísa
bírókratar	bjúrókratar
birsr	birst
birsta	birta
birtigarmynd	birtingarmynd
birtingamynd	birtingarmynd
birtis	birtist
birttist	birtist
biskæra	blikskæra
biskæri	blikskæri
biskub	biskup
bískupbiskup	biskup
biskupss	biskups
biskupsstaf	biskupsstarf
biskupstóll	biskupsstóll
bismari	brimari
bismark	bitmark
bisnanna	bisanna
bíspertur	bísperrtur
bístjóri	bílstjóri
bistró	biðgró
bítaðu	bíttu
bitfar	bifar
bítha	bíta
bitl	bil
bítm	bít
bítta	bíta;býtta
bítti	býtti
biturleyki	biturleiki
bíunn	íunn
bívan	Ívan
bixir	fixir
bixsr	fixar
bj-rn	björn;Björn
bjæð	bræð
bjæor	bjór
bjærk	björk
bjærtur	bjartur
bjagiðu	bjagaðu
bjálla	bjalla
bjání	bjáni
bjäor	bjór
bjargam	bjarga
bjargand	bjargandi
bjargarð	bjargað
bjargry	Bjargey
bjargun	björgun
bjargvættsins	bjargvættarins
bjarki	Bjarki
bjarkja	Bjarka
bjarkur	Bjarki
bjarn	Bjarni;björn;Björn
bjarndal	Bjarnadal
bjarni	Bjarni
bjarnry	Bjarney
bjarr	bjart;Bjart
bjart-	bjart;Bjart
bjartae	bjarta;Bjarti
bjartssýnn	bjartsýnn
bjártsynn	bjartsýnn
bjartsynni	bjartsýnni
bjarttur	bjartur;Bjartur
bjartur-	bjartur;Bjartur
bjartut	bjartur;Bjartur
bjarvættur	bjargvættur
bjást	brást
bjastra	bjástra
bjátistu	bjátinu
bjatla	bjalla
bjatrsýn	bjartsýn
bjatrsýni	bjartsýni
bjatrsýnn	bjartsýnn
bjatsýnn	bjartsýnn
bjattla	jatla
bjatur	bjartur
bjða	bjóða
bjé	bjó
bjegg	begga
bjes	jes
bjo	bjó
bjò	bjó
bjo´ta	brota
bjo=rn	björn;Björn
bjóa	bjóða
bjoda	bjóða
bjoða	bjóða
bjóda	bjóða
bjóđa	bjóða
bjóða	bjóða
bjöða	bjóða
bjőða	bjóða
bjóða.	bjóða
bjóðadetta	bjóða;detta
bjóðaði	bjóðiði
bjóðar	bjóða
bjóđi	bjóði
bjoðja	bjóða
bjóðq	bjóð
bjóđu	bjóða
bjóđur	bjóður
bjóðw	bjóð
bjöguö	bjögun
bjölgun	fjölgun
bjoll	bjöllu
bjolla	bolla
bjöllan	bjallan
bjóm	bjó
bjor	bjór
bjòr	bjór
björ	björn;Björn;bjór
bjorg	björg;Björg
björg­	björg;Björg
björgey	Bjargey
björgheiðue	Björgheiður
björgumarmenn	björgunarmenn
bjorgunsrsveitir	björgunarsveitir
bjorgvin	Björgvin
bjorgvín	Björgvin
björhunarsveitarmenn	björgunarsveitarmenn
bjork	björk;Björk
bjorm	björn;Björn
björm	björn;Björn
björna	björn;Björn
björnmár	björn;Björn;már;Már
björnssson	Björnsson
björnur	björnum;bjórnum
bjorson	Brárson;Björnsson
bjórst	bjóst;bjór
bjort	björt;Björt
bjōrt	björt;Björt
björvin	Björgvin
bjóta	bjóða;brjóta
bjóüa	bjóða
bjøuga	bjúga
bjria	bjarga
bjsrgar	bjargar
bju	bjó
bjua	bjáa
bjuga	bjúga
bjûga	bjúga
bjúggu	bjuggu
bjúgne	bjúgnef
bjútí	býti
bjýg	bjúg
bjýga	bjúga
bk	bak
bkóða	bjóða
bkörk	björk;Björk
bksl	basl
bkússa	blússa
bkýantinum	blýantinum
bl	bæ
bl´	bil
blå	blý
bla´d	bland
bláann	bláan
bláar.	bláar
blábrert	blábert
blad	blað
blaď	blað
blađ	blað
blaðabúnka	blaðabunka
bladagrein	blaðagrein
blaðagreins	blaðagrein
blađi	blaði
bláðið	blaðið
blaðlestur	blaðalestur
blaðmað	blaðað
blaðmaður	blaðamaður
blaðrana	blaðranna
blaðsi	blaði
blaðsið	blaðið
bladsiða	blaðsíða
blaðsiða	blaðsíða
blaðsída	blaðsíða
blaðsiðurnar	blaðsíðurnar
bladuer	blaður
blaðunum	blöðunum
bláður	blaður
blæðða	blæða
blædīs	blædís
blæing	blæðing
blæjda	blæja
blæsi	blæs
blæsja	blæja
blæskrar	blöskrar
blætina	blæstina
bláfall	bláfjall;Bláfjall;bláfell;Bláfell
bláfjell	bláfjall;Bláfjall;bláfell;Bláfell;bláfjöll;Bláfjöll
blald	bland
bláleytur	bláleitur
blámalað	blámálað
blandadur	blandaður
blandaþoka	blindþoka
blandíska	landísa
blank	blak
blaq	blað;blak
blar	blár
blàr	blár
blara	bara
blasíða	blaðsíða
blásiða	blásið
blasíði	blasiði
blasiðu	blasirðu
blásiðu	blásið
blasiðum	blasiði
blasíður	blaðsíður
blaskir	blasir
bláskó	bláskóg
blássari	blásari
blàstur	blástur
blátonn	blátönn
blátr	blátt
blaukat	baukast
blaum	bláum
blaunta	blauta
blauntur	blautur
bláur	blár
blausar	lausar
blaustar	blautar
blaustra	blautra
blautleiga	blautlega
blautor	blautur
blauttur	blautur
bldökkt	blædökkt
blef	bleif
bleggur	leggur
blegíu	Belgíu
bleija	bleyja;bleia
bleijuna	bleyjuna;bleiuna
bleikað	bleika
bleikasturinn	leikurinn
bleikka	bleika
blejkur	bleikur
bleju	bleyju;bleiu
blejya	bleyja;bleia
blekasti	bleikasti
blekhylkir	blekhylki
blekslaus	flekklaus
blekti	blekkti
blelluð	brelluð
blendiefni	íblendiefni
blends	blinds
blesaa	blessa
blesdaður	blessaður
blessaðarri	blessaðri
blessapur	blessaður
blesseður	blessaður
blessninn	blessuninni
blessuð!	blessuð
blesuð	blessuð
bléttótt	blettótt
bleya	bleyta;bleyja;bleia
bleyk	bleik
bleykt	bleikt
bleykti	bleyti
blezan	blesan
blíant	blýant
bliantur	blýantur
bliantúr	blýantur
blíantúr	blýantur
bliðkast	blíðkast
blíðlegue	blíðlegu
bligg	blogg
blíit	blítt
blikkinn	blikinn
blikkur	blikur
blikkviti	blikviti
blindbilur	blindbylur
blinhríðinni	blindhríðinni
blióm	blóm
bliskar	blikar
bljá	blá
bljóður	bjóður
bljúk	bljúg
blöð.	blöð
blöð7	blöð
blóðburg	blóðberg
blöðdru	blöðru
blóðgjof	blóðgjöf
blöðgjöf	blóðgjöf
blóðhöfnir	blóðhefndir
blöđin	blöðin
bloðkorni	blóðkorni
blóðmíga	blóðmiga
blóðpróa	blóðprófa
bloðprofa	blóðprófa
blóðpruf	blóðprufu
blóðprúfa	blóðprufa
bloðprúfu	blóðprufu
blóðprýstingur	blóðþrýstingur
blödr	blöndur
blödra	blöðru
blóðrék	blóðrík
bloðru	blöðru
blödru	blöðru
blöðrusig	blöðrustig
blóðsykkur	blóðsykur
blóðsykkurinn	blóðsykurinn
bloðsýkur	blóðsykur
blóðsykurin	blóðsykurinn
blöðungum	blöðunum
blöðungur	blöðunum
blóðþristing	blóðþrýsting
blóðþristingur	blóðþrýstingur
blóðþristingúr	blóðþrýstingur
blóðþrýsingur	blóðþrýstingur
blóðþrysting	blóðþrýsting
blóðþrýstingin	blóðþrýstinginn
blóðþrystingur	blóðþrýstingur
blóðþrystingurinn	blóðþrýstingurinn
bloggsíðunno	bloggsíðunni
blóginn	bóginn
blókasafn	bókasafn
blókk	blokk
blokkirnna	blokkirnar
blokkirnnar	blokkirnar
blokkrinar	blokkirnar
blokkun	flokkun
blokkur	flokkur
blökra	blöskra
blom	blóm
bloma	blóma
blómabuð	blómabúð
blómabuðin	blómabúðin
blómapóttur	blómapottur
blomavasi	blómavasi
blómín	blómin
blómkálsúpa	blómkálssúpa
blómö	blóm
blómör	blóðmör
blómpottur	blómapottur
blómsterar	blómstrar
blomstrandi	blómstrandi
blomstur	blómstur
blömvöndur	blómvöndur
blönð	blöð
blondína	blundina
blöndos	Blönduós
blöndós	Blönduós
blöndúos	Blönduós
blontuós	Blönduós
blöntúós	Blönduós
blood	blóð
blook	blokk
blóom	blóm
blóprufa	blóðprufa
blør	blár
blórabögull	blóraböggull
blortana	blotana
blöskrađi	blöskraði
blöslra	blöskra
blotnara	blotnar
blótsyrð­in	blótsyrðin
blótt	blátt
blour	bolur
blövun	bölvun
blrikur	blikur
blsðsiða	blaðsíða
blussu	blússu
bluten	blautan
blýanntur	blýantur
blýant	blýant
blyánta	blýanta
blyantar	blýantar
blýantaur	blýantur
blýanti	blýanti
blyantur	blýantur
blýantur	blýantur
blyast	blíast
blyðgun	blygðun
blyguð	blygð
blyjantar	blýantar
blýjantar	blýantar
blýjið	blýið
blyndni	blindni
blysar	blysa
blystar	lystar
blýstra	blístra
blýtant	blýant
blýtantinn	blýantinn
blýtantur	blýantur
bmî	bæ
bmun	mun
bmynd	mynd
bnef	nef
bó	bjó
bó´lgnar	bólgnar
bö5n	börn
boælta	bolta
board	borð
boarðaður	borðaður
boat	bot
bób	bók;bón
bod	boð
bođ	boð
bóðannir	boðarnir
boðaslega	boðlega
bodberi	boðberi
boðeyri	Borðeyri
bóðháttur	boðháttur
bođi	boði
bódi	bóndi;bófi
bóðinnar	boðinnar
bódni	bóndi
boðr	borð
boðslega	boðlega
boðstóll	boðstólar;borðstóll
boðstólnum	boðstólum
böðunn	böðun
böðunni	böðuninni
boðuns	boðun
body	boði
boeg	borg
bœttir	bættir
bófast	bólfast
bófin	bófinn
bofra	bora
bofsin	bofsi
bófu	bófi
bog	bók
bogfimis	bogfimi
bogfmis	bogfims
boggi	moggi
böggvistöðum	Böggvisstöðum
bógnar	bognar
bógu	bógur
bögull	böggull;böðull
bogunar	borgunar
bói	bófi;bógi
bok	bók;lok
bòk	bók
bôk	bók
bõk	bók
boka	poka;bóka
bókaarkápa	bókarkápa
bókabíð	bókabúð
bókabuði	bókabúðin
bókabuðin	bókabúðin
bókaflókkana	bókaflokkana
bókaflókkanna	bókaflokkanna
bókaflókkur	bókaflokkur
bókahaldari	bókhaldari
bókakafli	bókarkafli
bókakápan	bókarkápan
bokakápunnar	bókarkápunnar
bókakápunnar	bókarkápunnar
bókalestri	bókalestri
bökan	bökun
bókarkaup	bókakaup
bókarkylina	bókarkilina
bókasafb	bókasafn
bokasafn	bókasafn
bókasafn	bókasafn
bókasafnfræði	bókasafnsfræði
bokasafninu	bókasafninu
bókasafninu.	bókasafninu
bókasfn	bókasafn
bókastaf	bókstaf
bókatitill	bókartitill
bókaútgáfs	bókaútgáfa
bókaverzlun	bókaverslun
bókemnntur	bókmenntir
bókemnta	bókmennta
bókfjall	bókafjall
bókhaldsfærsla	bókhald;bókfærsla
bókhil	bókhald;bókahilla
bókhila	bókahilla
bókhilla	bókahilla
bókinna	bókina
bokinni	bókinni
bókinu	bókina;bókin
bókj	bók
bokkrinar	blokkirnar
bókl	bók
bókmenn	bókmennt
bókmenntastefnum	bókmenntastefna
bókmenntaverðalun	bókmenntaverðlaun
bokmenntir	bókmenntir
bókment	bókmennt
bókmentir	bókmenntir
bókmenttir	bókmenntir
bókmentunn	bókmenntun
bókmentunum	bókmenntunum
bókmentur	bókmenntir
bóks	bók
boksafn	bóksafn
bóksins	búksins
bókstaf	bókstaf
bokstafir	bókstafir
bókstofum	bókstöfum
bokstri	bakstri
boksur	bokkur
böktinu	böltinu
böktinum	böltinum
bokuna	bökuna
bókuna	bókun
bòla	bíla;bóla
bólafesta	bólfesta
bólakef	bólakaf
bólevæia	Bólivía
bólevía	Bólivía
bolga	bólga
bolgí	bogi
bolgueyðandi	bólgueyðandi
bólgurs	bólgur
bólir	bolir
bólivia	Bólivía
bólívía	Bólivía
bólívíska	bólivíska
bólívískt	bólivískt
bólk	fólk;bók
boll	bol;bolli;bíll;böll
bollanminn	bollann;minn
bollannum	bollanum
bollarnier	bollarnir
bólli	bóli;bolli
bollin	bollinn;böllin
bóllir	bellir
bollit	bolli
bollli	bolli
bollqr	bollur
bollt	bolt
böln	börn
bólstafur	bókstafur
bólstandi	bólstrandi
bólta	bolta
boltalwikir	boltaleikir
boltarrum	boltanum
bolte	bolta
boltí	bolti
bólti	bolti
bóltin	boltinn
bóltinn	boltinn
boltunn	boltinn
boluer	bolur
bölunu	bölunum
bölvaðuur	bölvaður
bölvast	bölva
bolvuður	bolviður
bömtinu	böltinu
bómullur	bómullar;bómull
bónasti	bóni
bónasts	bónaðasts
bóndabýl	bóndabýli
böndar	bendar
bóndaum	bóndanum
bónđi	bóndi
bóndir	bóndi
bóndu	bóndi
bóndui	bóndi
bondur	bændur
bónfi	bóndi
bonnie	bogi
bönom	bönum
bónsi	bóndi
bónt	bót;bón
bónta	bóta;bónda
bontlangi	botnlangi
bontlanginn	botnlanginn
böntý	Benný
bonus	bónus
bonús	bónus
bøok	brok
böótia	bóta
bopskapur	boðskapur
boraga	borga
borara	borgara
bord	borð
borđ	borð
bórd	borð
bórð	borð
borda	borða
borđa	borða
borðaer	borðar
bordar	borðar
borðdu	borðuðu
borðendi	borðandi
bordi	borði
bordid	borðið
bórđiđ	borðið
bordina	borgina
borðini	borðinu
borðinnu	borðinu
bordinu	borðinu
borđinu	borðinu
borðip	borði
borđír	borðir
borðo	borð
borðq	borð
borðstovuna	borðstofuna
borehola	borhola
borgaan	borgaðan
borganes	Borgarnes
borganess	Borgarness
borgarastrijaldar	borgarastyrjaldar
borgarastryjaldar	borgarastyrjaldar
borgarastyjöld	borgarastyrjöld
borgarbryggð	borgarbyggð
borgareyrum	Borgareyri
borgarfjörður	Borgarfjörður
borgarmarkana	borgarmarkanna
borgarninnar	boran
borgatún	Borgartún
borgmyndun	borgamyndun
borguna	borgina
borgunni	borginni
börgvin	Björgvin
börir	berir
boris	borist
borit	borið
börkue	börkur;Börkur
börm	börn
born	börn
börn.	börn
bornin	börnin
bórnin	börnin
börning	börnin
börr	börn
borrgun	borgun
borvel	borvél
bórvel	borvél
bös	nös
bósálfi	búálfi
bosporussund	bospórussund
boston	bosson
botgari	borgari
botla	bolta
botli	botni;bolti
bótli	bóli
botll	botél
botlti	bolti
botnin	botninn
botníu	Bosníu
botnlang	botnlanga
botnledja	botnleðja
botnlsngan	botnlangann
botnslaus	botnlaus
botnsúlur	botnssúlur
bóun	bókun
bövarr	bölvar
bövun	bölvun
boxaís	boxast
böxar	boxar
boxina	boxinu
boxq	box
bóxur	buxur
boy	bo
boyan	boran
bøyning	beining
bprðið	borðið
br´f	bréf
bra	bara
braaut	braut
bráðabirða	bráðabirgða
bráðabirðga	bráðabirgða
bráðabirgði	bráðabirgða
bráðabriðga	bráðabirgða
bráðamotaka	bráðamóttaka
bráðamotta	bráðamóttaka
bráðmóttaka	bráðamóttaka
braðna	bráðna
bràðna	bráðna
bráðnand	bráðnandi
brádskemmtileg	bráðskemmtilega
bráðsmóttaka	bráðamóttaka
bráðu,	bráðu;bráðum
bràðum	bráðum
bráðum8	bráðum
bræðarna	bræðurna;bræðranna
bræðarnna	bræðranna
bræðr	bræður;bræðir
bræðska	bræðsla
bræðuna	bræðsluna
brædur	bræður
bræoður	bræður;bróður
bræton	ræon
brættun	úrættun
brætun	bætur
brætún	brún
brætur	bætur
bræunn	brunn;brúnn
brág	brá;brag
bragahætti	bragarhætti
brágd	bragð
brágð	bragð
bragdast	bragðast
bragðauki	bragðlauki
bragðgadur	bragðgóður
bragðgódur	bragðgóður
bragreglum.	bragreglum
brágst	brást
brai	bragi
braið	brauð
brakaðs	brákaðs
brálað	brjálað
brálaður	brjálaður
brálæði	brjálæði
bramsana	bramana
branka	banka
brannd	brand
branndur	brandur
braoð	brauð
bráóum	bráðum
bráq	brá
brasana	brassana
brasilæia	brasilía
brasíli	barsíli;Brasilía
brasília	Brasilía
brásilkur	brasilskur
brat	brot
bratinn	brotinn
bratinni	brautinni
braud	brauð
brauđ	brauð
brauðann	brauðanna
brauðhleipur	brauðhleifur
brauđi	brauði
braudið	brauðið
brauðist	brauðrist
brauðmylgsna	brauðmylsna
brauðmyslnum	brauðmylsnu
brauðrisit	brauðrist
brauðrísti	brauðristin
bráuðvél	bráðvel;brauðvél
braugh	brauk
brautrydjandi	brautryðjandi
brautryðjanði	brautryðjandi
brautrynjandi	brautryðjandi
brautrýnjandi	brautryðjandi
brauü	braut
bre´f	bréf
breað	breið
breakfast	breskast
breð	breið
bréð	bréf;bréfið
bréður	bróður;bráður
bref	bréf
brèf	bréf
bréf,	bréf
brefað	bréfað
brefður	bregður
bréffowm	bréfform
brefið	bréfið
bréfið.	bréfið
brefjað	refjað
brég	bréf
bregda	bregða
bregðaast	bregðast
bregðsat	bregðast
bregðst	bregðast
breggðast	bregðast
bregpur	bregður
bregrún	Bergrún
bregsa	bregða
breiæa	breiða
breida	breiða
breiðarblik	Breiðablik
breiðarfjörður	Breiðafjörður
breiddargtáða	breiddargráða
breiddst	breiddist
breiðfjörður	Breiðafjörður
breidholt	Breiðholt
breidholti	Breiðholti
breiðolt	Breiðholt
breiðoly	Breiðholt
breimina	breiminu
breinglanðann	brenglaðan
breinlaða	brenglaða
breinlaði	brenglaði
breinlaður	brenglaður
breita	breyta
breitast	breytast
breiti	breyti
breiting	breyting
breitingar	breytingar
breitjið	breytið;brytjið
breitta	breytta
breittu	breyttu
breittur	breyttur
breiya	breiða;breyta
brékan	brekan;brekán
brékán	brekán
brekkunar	brekkunnar;brekkurnar
bréklamma	bréfklemma;bréfaklemma
bréklemma	bréfklemma;bréfaklemma
bremlaður	bramlaður;brenglaður
bremmsukloss	bremsuklossa;bremsuklossi
bremsaðs	bremsað
bremsaður	bremsaðu
brendi	brenndi
brendur	brenndur
brengalð	brenglað
brenjlaður	brenglaður
brenlaður	brenglaður
brennlaður	brenglaður
brennnisteinn	brennisteinn
brenska	breska;enska
brent	brennt
brenug	brekug
brés	bréfs
bressk	bresk
brésti	bresti
brestq	brest;breskt
bret	breti
brét	bréf
bréti	bréfi;breti
brétibríeti	breti;bríeti
bretlamd	Bretland
brétland	Bretland
bretlandi	Bretlandi
brétt	brett
brettareið	brettari
breutingar	breytingar
brexit	breitt
breyast	breytast
breyðast	breiðast
breydd	breidd
breyddur	breiddur
breyðu	breiðu
breyðuð	reyðuð
breygðuð	beygðuð
breygður	bregður
breyggja	bryggja
breying	breyting
breykja	reykja
breyksleiki	breyskleiki
breynglað	brenglað
breynglaður	brenglaður
breynlaða	brenglaða
breynlaður	brenglaður
breys	breyta;breyst
breysta	breyta;breyst
breything	breyting
breytillegt	breytilegt
breytingalög	breytingarlög
breytingana	breytinganna
breytingarlaus	breytingalaus
breytingarskeið	breytingaskeið
breytja	breyta;brytja
breytjið	breytið;brytjið
breyts	breyst
breyttisst	breyttist
breyttym	breyttum
breytuð	breytu
breyur	breytur
brezta	bresta
brglót	Bergljót
brgur	Bergur
brí	frí;brú
bría	brúa
bridda	brydda
bridge	brids
briðja	biðja;bryðja
briðmill	brimill
bridshanda	brimsanda
briéf	bréf
bríet	Bríet
brietu	brittu;Bríeti
brífa	rífa
bright	brigt
brik	brík
brimbetti	brimbretti
brimbrettibrun	brimbrettabrun
brimina	briminu
brimirll	brimill
brimlaður	brimlöður
brimur	brimurð
brina	bruna
brína	brýna
brinda	binda
brindís	Bryndís
brindys	Bryndís
bringlaða	brenglaða
bringlaði	brenglaði
bringlaður	brenglaður;ringlaður
brinhildur	Brynhildur
bríni	brýni
brínimum	brýninum
brinna	brynna
brío	brík
brióta	brjóta
brisinga	brislinga
brisingur	brislingur
briskjand	breiskjan
briskjandi	beiskjandi
brist	bryst
briti	birti;bryti
britt	beitt;breitt
britur	birtur
bríwt	bríet
brjá	hrjá
brjal	brjál
brjálaðingur	brjálæðingur
brjaladur	brjálaður
brjaladut	berjalaut;brjálaður
brjáluður	brjálaður
brjánsar	bjánar
brjoða	bjóða
brjóða	bjóða;rjóða
brjöóst	brjóst
brjos	bros
brjósa	frjósa
brjósinu	brjóstinu;brjóskinu
brjöst	brjóst
brjóstamál	brjóstmál
brjóstklos	brjósklos
brjóstun	brjóstum;brjóstunum
brjóstvíði	brjóstsviði
brjóstykri	brjóstsykri
brjota	brjóta
brjóta	brjóta
brjótinu	brjóstinu
brjótna	brjóta
brjótta	brjóta
brjótur	brjótur
brjuta	brjóta
brkir	birkir
brkkk	brokk
brljar	beljar
brn	barn;brún
brnadari	brandari
broasa	brosa
brođ	roð
broðar	boðar;bróður
broddgaltarh	broddgaltar
broder	broderi
broðer	bróðir
bróðhófur	broðhófur
brodíe	bróðir
brodír	bróðir
broðir	bróðir
bródir	bróðir
bróđir	bróðir
bròðir	bróðir
bröðir	bróðir
bróðirmömmu	bróðir;mömmu
bróðirr	bróðir
bróðit	bróðir
bröðru	blöðru
bróðu	bróður
bróðuir	bróður
brodur	bróður
broður	bróður
bróður.	bróður
bróðuy	bróður
bróðyrsonur	bróðursonur
brófubeinak	rófubeina
brogarlandslag	borgarlandslag
brogin	borgin;bogin
brögs	brögð
broileri	brilleri
brókaì	bróka
brókast	bókast;brókast
brokinni	brókinni
brokkol	brokkolí
bróklin	bróklin
bróklind	bróklind
bróklindi	bróklindi
brokoli	brokkolí
brokolí	brokkolí
brókoli	brokkolí
brómsir	krómsir
brön	bröns
bröndurun	bröndurum;bröndurunum
bröngarar	brenglarar
bröngarur	bröngsuð
brönsinn	bransinn;brönsinn
bronspenningar	bronspeningar
bronsupeningar	bronspeningar
bronsurpeningar	bronspeningar
broogöltur	broddgöltur
broogöltut	broddgöltur
brópir	bróðir
brópur	bróður
brósa	brosa;brósa
brosaðu	brostu
brósandi	brosandi
brósir	bróðir
broskall	broskarl
broskallar	broskarlar
broskallinn	broskarlinn
broskarlin	broskarlinn
brosmildni	brosmildi
brósó	bros;brósi
brosoðu	brösuðu
brosq	bros
brossi	brosi;bossi
brost	brostu;brosti
brosuðu	brösuðu;brostu
brösuleg	bröstuleg;brösulega
brösulega	brösuglega
brót	brot
brotfar	brotnar
brothættulegur	brothættur
brötla	brölta
brotstj	brosti
brottfallinn	brottfallið
brottfallur	brottfall
brottfarastaður	brottfararstaður
brottfelly	brottfalli
brottfelt	brottfall
brottflutningut	brottflutningur
brotthætt	brothætt
brotthættur	brothættur
brotthvaf	brotthvarf
brottin	brotin
brottná	brottnám;brotna
brottnádi	brottnámi;brotnaði
bróttnádi	brottnámi;brotnaði
brottnam	brottnám
bróttnam	brottnám
brott­rekstur	brottrekstur
brottresktur	brottrekstur;brottrækur
brottreskur	brottrekstur;brottrækur
brottröktu	brottræku
brottvisunin	brottvísunin
brottvisuninn	brottvísuninni
brottvísuninn	brottvísunin
bróun	þróun
brrða	borða
brréf	bréf
brrosa	brosa
brskel	skel
brste	birst
brtuna	birtuna
bruð	bruðl
brúđan	brúðan
bruder	brúðar
bruðgumi	brúðgumi
brúðie	brúði;brúður
brúðis	brúði
bruðlq	bruðl
brúðmei	brúðarmey
brúðmey	brúðarmey
brúðpur	brúður
brúdur	brúður
brúðurni	brúðurin;brúðurinni
brúðurnótt	brúðkaupsnótt
brufa	prufa
brugðat	bregðast;brugðist
brugði	brugðið;bregði
brugðiá	brugðið
brugðst	brugðist
brugt	burðugt
brúinn	brúin
brull	bull;bruðl
brulla	bruðla
brullhlaup	brullaup
brúmey	brúney
brúminum	bríminum
brumsan	bremsan
brunastodum	brunastöðum
brunch	bruns;bröns
brúnf	brúnt
brungar	brunar;ungar
brunl	brun
brunnkluka	brunnklukka
brúnnt	brúnt
brúnrauæ	brúnrauð
brunsj	bruns;bröns
brúnsvík	Brúnavík
brunt	brund
brúnur	brúnn
brupkaup	brúðkaup
brúpkaup	brúðkaup
brus	brúsi
brusan	brúsan;brúsann
brusel	brussel
brusi	brúsi
brússi	brúsi
brussuð	brussur
brusuleg	brussuleg
brútust	brutust
brwgða	bregða
brýa	brúa
bryða	bruða
bryggði	byggði
brýggja	bryggja
bryggjuni	bryggjunni
brygslur	brigslar
bryjálapur	brjálaður
bryjarr	brynjar;byrjar
bryjna	brynja
bryjun	byrjun
brykjan	brynjan;bryggjan
brykkju	drykkju;bryggju
brym	brim
brymlaðan	bramlaðan
brymlaður	bramlaður
brýndann	brýndan
bryndíd	Bryndís
bryndis	Bryndís
bryndís	Bryndís
brynglaða	brenglaða
brynglaður	brenglaður
brýnja	brynja;brýna
bryóta	brjóta
brýrn	brýr;brýnn
brýrnnar	brýrnar;brýnnar
bryskjandi	breyskjandi
bryt	brot
brýtja	brytja
brytnar	brotnar
brýtr	brýtur
bsaka	baka;saka
bsiggi	siggi;Siggi
bsjá	sjá
bskari	bakari
bskipi	skipi
bskki	bakki
bsrn	barn
bsta	besta
bstaðsetning	staðsetning
bstur	bestur
bt	bit
btéf	bréf
btenna	brenna
bteyskleiki	breyskleiki
bteyskleoki	breyskleiki
bteyta	breyta
bteytast	breytast
btré	tré
bu	bú
bua	búa
buá	búa
búa.	búa
búa1	búa
búaa	búa
buabúa	búa
buanagras	baunagras
bubbla	bobbla;búbbla
búbblan	júbbulegan
búbúinn	búbúinn;búinn
bucur	buxur
buð	búð;bað
búđ	búð
bùð	búð
büð	búð
búðaðann	búðaðan
búðaðans	búðaðan
búðareigandanna	búðareigandann
búðarferð	búðarverð
búðartóptanna	búðartóftanna
búðasa	búðaða
búdd	búdda
búddanum	búddunum
buðge	buga;bugða
búđiđ	búðið
buðin	búðin;boðin
búðína	búðina
buðing	búðing
búðini	búðinni
búđinni	búðinni
buðinu	boðinu
buđir	búðir
buðir	búðir
buðirnar	búðirnar
búdirnar	búðirnar
búđirnar	búðirnar
búðirnarð	búðirnar
buðl	bruðl
búðni	búðin
budu	buðu
búdunum	búðunum
buesta	besta
búfa	búa
bufall	buffall
buffalo	buffal
buffalói	buffli
buffee	buffet
búffer	buffet
búga	búa
bugð	bugað
bugði	bugaði
bugf	bug
bugiða	bugða
bugiðu	bugðu;bugirðu
bugl	bug
bugo	bugi
buið	búið
búiðbúinn	búiðbúinn;búið;búinn
build	buldi
buin	búin;bein
buín	búin;burn
búin.	búin
búinbúinn	búinbúinn;búin;búinn
búinganna	búninganna
búingar	búningar
búininur	búningur
buinjn	búinn
buinn	búinn
buínn	búinn
buip	bupp
búja	búa
bújörður	bújörðum
bukannir	bunkarnir
búkrinn	búkurinn
búksur	búkur
bulda	hulda
búlgaria	Búlgaría
búlgarisk	búlgarísk
bulgariska	búlgaríska
búlgvarskur	búlgarskur
bulir	bunir;gulir
bullár	bullar
búllí	búllu
bulnast	bunast
bulr	bull
búlsma	fúlsa
bulur	bylur
bumfinn	bumbinn;bundinn
bumoll	ball;bómull
bumt	búnt
bun	buna
búnapar	búnaðar
búndid	bundið
búndið	bundið
bundinar	bundinnar
bunding	bundin
bundinnn	bundinn
búngaður	búnaður
bungun	bugun
búngur	bungur
búnigur	búningur
búninbur	búningur
buninga	búninga
buningi	búningi
búningklefana	búningsklefana
búningklefar	búningsklefar
búningsastöðu	búningsaðstöðu
búnka	bunka
bunkur	bunur;bunkar
bunnd	bind
bunnt	unnt
buø	bug
bupið	buppið
búpin	búin
búq	bú
burað	burða
burar	burðar
burðs	burða
búretta	bretta
búrkina	búrkona
burmans	bermans
búrmanskt	birmanskt
burmönskur	birmönskum
burpa	bura
búrsforræði	búsforræði
burth	burt
buryt	burt
búsaga	búrsaga
búsáhold	búsáhöld
búsálhöld	búsáhöld
búsetaður	búsettur
búsetar	búsettar
búsif	búsi
búsin	búin
buskað	buska;buslað
buskaðu	bukkaðu;buslaðu
buskin	buskinn
buslinni	buslunni
buss	busa
bustaður	bústaður;burstaður
busti	bursti
bustir	burstir
búströrfum	bústörfum
bustuð	burstuð
but	bút
bútunn	bútun
buúm	búum
buur	buxur;bunur
búusettir	búsettir
buxnaskál	buxnaskálm
buxn­a­streng	buxnastreng
buxn­a­strengnum	buxnastrengnum
buxom	buxum
buxsur	buxur
buxu	buxur;uxu
buxuð	buxur
buxunn	buxunum
buxunur	buxunum
buxúr	buxur
búxur	buxur
búxúr	buxur
buxurinn	bugurinn
búxurnar	buxurnar
buxutr	buxur
bví	bí
bwnda	bænda;banda;benda
bwra	bara
by	bý
býa	búa
býbúinn	nýbúinn
byð	bið
býða	bíða
byðja	biðja
byðjum	biðjum
byðs	biða
bydst	byðust;býðst
býðsy	býðst
byður	býður;biður
býdur	býður
býfast	blýfast
býfasti	blýfasti
byflinn	bylinn
bÿfluga	býfluga
bÿflugur	býflugur
bygð	byggð
bygða	byggða
bygðan	byggðan
bygðu	byggðu
bygga	byggja
byggðann	byggðan
byggðanönnum	byggðamönnum
byggdi	byggði
bygge	bygg
bygggja	byggja
byggibyggji	byggi
byggingalýsing	byggingarlýsing
byggingalyst	byggingalist
bygg­ing­ar	byggingar
byggingararfurr	byggingarþarfir
byggingareitur	byggingarreitur
byggingarframkvæm	byggingarframkvæmd
byggingarframkvæmdirnar.	byggingarframkvæmdirnar
byggingartimbur	byggingatimbur
býggingarvinna	byggingarvinna
byggingavöruversun	byggingavöruverslun
bygg­ing­in	byggingin
bygg­ing­ir	byggingar
bygg­ing­o	byggingu
byggining	bygging
byggjakja	byggakra
byggjir	byggir
byggjq	byggja
bygguðstu	byggðustu
bygguðustu	byggðustu
bygguni	bygginni;bryggjunni
byggva	byggja
byging	bygging
bygja	byggja;beygja
bygjast	byggjast;byrgjast
byiji	byrji
byjja	byrja
byjun	byrjun
bykað	bikað
byko	bik
býlantur	blýantur
bylgurnar	bylgjurnar
býling	býli
býlisl	býlis
býliss	býlis
bylmingshögn	bylmingshögg
bylni	ylni;bylinn
bylnin	bylinn
byltingakenda	byltingarkennda
byltingakennda	byltingarkennda
byltingakenndar	byltingarkenndar
byltingarkendar	byltingarkenndar
byltingarkenddar	byltingarkenndar
bylts	bylta
byndast	bindast
bynding	binding
byndingar	bindingar
bynginn	binginn
bynstu	binstu
byóða	bjóða
byŕ	býr
býrajðu	byrjaðu
býrðja	byrja
býrdu	býrðu
byrgjir	byrgir;birgir
byrgjunn	byrjunin;byrjun
byrhja	byrja;birgja
byria	byrja
býrija	byrja
byrist	byrjist;berist;borist
býrja	byrja
byrjandur	byrjendur
byrjas	byrja;byrjað
byrjðum	byrjuðum
byrjendalæsi.	byrjendalæsi
byrjendi	byrjandi
byrjhn	byrjun
byrjing	byrji;byrjun
byrjinn	byrjun
byrju	byrjun
byrjudu	byrjuðu
byrjuni	byrjun;byrjunin
byrjunnini	byrjuninni
byrkningum	byrkningnum
byrlungur	byrlunar
byróta	byrta;brjóta
býrq	býr
byrr	fyrr;byr
býrr	býr
byrrist	birtist
byrtingamynd	birtingarmynd
bysa	byssa;busa
bysi	busi
býsi	býst
býsinq	býsins
byskup	biskup
byskups	biskups
byskupsins	biskupsins
bysna	býsna
byssubrendur	byssubrenndur
byssumið	byssusmið
byssun	byssu
byssuskapt	byssuskot;byssuskaft
byssuskepti	byssuskefti
bysum	byssum
býsvax	bísvax
byta	bita;býta
bytiburi	býtibúri
býtingur	býtingar
bytri	bitri
býtu	býtum
byygja	byggja
bzr	bar
bzra	bara
bzrja	byrja
cafe	af
cálsma	sálma
can	an
canada	kanada
caritas	Karitas;Karítas
carmeni	Carmen
carníum	sarínum
casat	sat
cast	sast
catn	vatn
caxa	saxa
centimetrar	sentimetrar
chai	hafi
chair	háir
charlea	Charles
cheka	hekla
chekka	tékka
cherrym	herrum
chia	Chile
chilí	Chile
chili-	Chile
chord	hörð
chose	hosa
christel	Kristel
cíceró	síseró
cið	sið
cider	der
cígarett	sígarettu
cígaretta	sígaretta
cígaretti	sígarettu
cigarettum	sígarettum
cinna	sinna
cinnur	vinnur
cirka	virka
ciskur	fiskur
cítron	sítrón
cítrona	sítróna
cjeka	sjeika
ckosta	kosta
claire	Clara
clausen	lausan
clean	legan
club	slubb
coin	soðin
cöldu	öldu;Öldu
coma	koma
con	son
coppa	soppa
cor	or
corten	Morten
cosmós	mosamós
crack	rask
crystal	kristal
cvið	við
cysta	ysta
d-ast	dast
d-kknandi	dökknandi
d.va	dvala
d´´ýrt	dýrt
d´ma	dæma;dóma
d´mi	dæmi;dómi
d´ós	dós
d´yr	dyr;dýr
d0gg	dögg
d0kkur	dökkur
da	dag
dáa	dáða;dáta
dabók	dagbók
dád	dáð
dáda	dáða
daðblað	dagblað
dade	daðey
dadi	daði
dáðini	dáðinni
daðo	daði
dádst	dáðst
dádyr	dádýr
dádýrintá	dádýrin
dæðann	doðann
dæðið	ódæðið
dæf	æf
dæfe	æfa
dægaðist	dægraðist
dægg	dögg
dægramundur	dægramunur
dægrana	dægranna
dægrasti	dægri
dæin	dæmin
dæji	gæi
dækjar	dækja
dækjara	dækja
dækkhærð	dökkhærð
dæliing	dæling
dæln	dælan
daemd	dæmd
daemdur	dæmdur
daemi	dæmi
dæminna	dæmanna
dæmio	dæmi
daemja	dæma
dæna	dæma
dænsk	dönsk
dæos	dós
dærslina	færsluna
dæsinn	bæsinn
dæskist	dælskust
dætum	dætrum
daetur	dætur
dæturs	dætur
dæur	dætur
daf	af
dafall	rafall
dáfð	dáð
dag.	dag
dagainn	daginn
dagatak	dagatal
dagaur	dagur
dagavilt	dagavillt
dagblad	dagblað
dagblađ	dagblað
dagbladid	dagblaðið
dagblaið	dagblaðið
dagblöðunum	dagblöðunum
dagblöður	dagblöðum
dágf	dag
dagfarsþruður	dagfarsprúður
dagferja	dragferja
daggu	döggu
dagguö	döggu
daggur	dagur;Dagur
daghylki	draghylki
dagim	dagi
dagin	daginn
daginm	daginn
daginnn	daginn
daginns	daginn
dagiur	dagur;Dagur
dagmar	Dagmar
dagn	dag;Dag
dagnú	Dagný
dagny	Dagný
dagný	Dagný
dagnÿ	Dagný
dagnyn	dögunin;Dagný
dagr	dagur;Dagur
dagrúin	Dagrún
dagsetningur	dagsetningu
dagsetninh	dagsetning
dagskránn	dagskránni
dagskrla	dagskóla
dagssatt	dagsatt
dagsset	dagset
dagssetning	dagsetning
dagssetninh	dagsetning
dagssins	dagsins
dagsskráliður	dagskrárliður
dagsskrárliður	dagskrárliður
dagsslægja	dagslægja
dagtal	dagatal
daguri	dagur
dagvjört	Dagbjört
dahar	dagar
dahbók	dagbók
dahur	dagur;Dagur
daíð	Davíð
dáíitið	dálítið
daim	damm
dainn	daginn
daka	taka
dakbók	dagbók
dakíska	taktíska
dakkur	dökkur
daktaðu	aktaðu
dakur	dagur
dalalæđa	dalalæða
dalari	dalar
dalbrú	dalbrún
dáleiðs	dáleiða
dáleyða	dáleiða
dáliti	dálítið
dálitið	dálítið
dálitíð	dálítið
dálítíð	dálítið
dalitill	dálítill
dalítill	dálítill
dálitíll	dálítill
dálkin	dálkinn
dálkinu	dálkinum
dálkir	dálkur
dálkni	dálki
dallest	ballest
dalllur	dallur
dalmatíska	dramatíska
dalsaa	dalsáa
dalsaá	dalsá
dalskaða	alskaða
dáltið	dálítið
dálvík	Dalvík
dam	Dan;dal
damíti	dínamíti
damlaðari	damlaðri
damosa	amosar
dámu	dánu
dan	Dani;Dan
danaði	dansaði
dánara	dánar
dánarbeðinu	dánarbeðinum
dánarbúðum	dánarbúum
dánari	dánar
dándág	dánardag
dandlaðist	dandalaðist
danéil	dani
danés	dans
dangirs	angurs
dangris	dagris
daníel	Daníel
danile	Daniel;Daníel
daníum	Danía
dánka	danka
dánkað	dankað
danmark	Danmörk
danmarkar	annmarkar;Danmerkur
danmökur	Danmerkur;Danmörku
danmörku	Danmörku
dánni	dáinni
danse	dansa
dansgolfinu	dansgólfinu
danskmaður	dansmaður
dansleið	dansleik
danslið	dansið
dansq	dans
dansur	danskur
dansurum	dönsurum
dápa	dáða
daphr	dapur
dappað	drappað
dappur	dapur
dáppur	doppur
dapr	dapur
daprask	daprast
dápu	drápu
dápur	dapur
dápurlegur	dapurlegur
dárastu	sárastur
darin	farin
darmstadtín	darmstatín
darpur	dapur
dárr	dár
darraða	darraðar
darraðg	darrað
darraðt	darrað
darraðu	darraður
darrir	darri
dárt	sárt
dásaðir	dasaðir;dásamaðir
dasáður	dasaður
dásamd	dásemd
dásamlegheit	dásamlegt
dásamlegur	dásamlegur
dáskist	háskist
daskrokkinn	skrokkinn
dásn	djásn
dasru	dastu
dasstu	dastu
dástaða	dást
dastaðið	afstaðið
dásuðu	dáðu
dátan	dátann
dati	mati
dátr	dáti
datta	datt
dattaði	fattaði
dattaðu	drattaðu
dattanir	battarnir
dáttir	dóttir
dáttum	dráttum;dátum
dátumm	dátum
dátur	dætur
dauda	dauða
dauðalíba	dauðalína
dauðaþögh	dauðaþögn
dauðdagur	dauðadagur
dáuði	dauði
dauðin	dauðinn
dauðionn	dauðinn
dauðoi	dauði
daudsins	daussins
dauðsins	auðsins
daudur	dauður
daufga	daufa
dáug	dug
daugfg	dögg
dauknir	auknir
daumen	daman
dáuni	dáinni
daurs	daðurs
dave	dvel
daví	Davíð
davide	David;Davíð
daxari	saxari
daybla	dymbla
dayja	deyja
days	dys
de	des
deagur	dagur
dearnir	delarnir
debate	debet
debíll	bíll
debitkort	debetkort
déð	séð
defer	deyfir
degis	degi
degja	deyja
degsetning	dagsetning
dei	degi
deia	deila
deifa	deyfa
deifing	dreifing
deiginum	deginum
deigjað	deigja
deignn	deigan
deigrum	deigum
deikd	deild
deildaðu	heildaðu
deildafundir	deildarfundir
deildafundum	deildarfundum
deildarfall	deildarfjall
deildarnar	deildirnar
deildarstjora	deildarstjóra
deildastjór	deildarstjóri
deildastjóri	deildarstjóri
deildastjórn	deildarstjórn
deildini	deildinni
deipt	deilt
deira	meira
deja	deyja
dekekað	dekkað
dekkhlaðið	drekkhlaðið
dekkhlaðinn	drekkhlaðinn
dekkjand	dekkjandi
dekkun	dekka
dekkur	dekkar;dekk;drekkur
deljaa	dvelja
dell	della
delstra	elstra
delu	deilu
demdu	dæmdu
demetra	fermetra
demíti	semíti
demonis	dennis
denmark	Danmörk
dennörk	Danmörk
dentir	dentur
depandi	drepandi
dergt	dengt
derngur	drengur
derraða	derrað
derts	ders
deryma	dreyma
désa	fésa
desembert	desember
desilitri	desílítri
desire	dæsir
deskist	dekkist
déskist	desjist
deskum	diskum
desur	dekur
dét	ét
dettanir	dettarnir
deukd	deild
deva	eva
devision	division
dexja	deyja
deya	deyja
deyandi	deyjandi
deyðar	deyða
deyðubil	eyðibil
deyðue	deyðu
deyður	deyfður
deyja.	deyja
deyjar	deyja
deyji	deyi
deypilyfi	deyfilyfi
deyrak	dreyra
deyskinn	feyskinn
dfrengur	drengur
dfyndinn	fyndinn
dhabi	hafi
dheraði	hernaði
di	dúi
dí	í
dicks	disks
dickurinn	diskurinn
did	dis
díd	dís
diffað	diffrað
dífill	fífill
dífis	dífist
diflað	duflað
difra	diffra
digrún	Sigrún
digs	dags;Dags;digurs
digurðardóttir	Sigurðardóttir
dikkust	dekktust;dökkust
diktat	diktan
dikurinn	diskurinn
dilarfulli	dularfulli
dilgist	diglist
dilgja	dylgja
dilija	Dilja;Diljá
dilijá	Diljá
diljá	Diljá
díljar	dílar
dílu	díl
dimalim	dimmalimm
dimisjon	dimisjón
dimmei	dimmey
dimmer	dimmir
dimmingar	dæmingar
dimmist	dimmast
dimmtir	dimmir
dimun	eimun
dímun	tímun
din	dyn
dínadýna	dýna
dínamík	dínamít;dýnamík
dínamísk	dínamíts;dýnamísk
dínamit	dínamít
dínamórarnir	dínamóarnir
dínamýk	dýnamík
diner	dunar
dingars	Ingvars
dingja	dyngja
dínner	fínnar
dintótt	dyntótt
dinur	dynur
dír	dýr
dírabjalla	dyrabjalla
dírð	dýrð
dírðka	dýrka
direkt	drekkt
dirfi	drifi
dírindis	dýrindis
diristu	dirfistu
díritísk	spíritísk
dírrindi	dýrindi
diryndis	dýrindis
disc	diss
dísell	dísill
disk-ur	diskur
dískar	diskar
diskara	diskar
diskari	diskar
diskin	diskinn
diskist	fiskist
dískist	pískist;frískist
diskiur	diskur
diskotans	déskotans
diskurnir	diskarnir
diskþurrka	diskaþurrka
dístu	dóstu
dít	dýr
dittað	dyttað
dittaðar	tittaðar
díun	díu
díur	síur;dívur
dívann	dívan
djáandi	sjáandi
djal	dal
djalarar	hjalarar
djas	djass
djáss	djass
djatfan	djarfan
djátistu	játastu
djoða	doða
djöfulsinns	djöfulsins
djöfyull	djöfull
djögla	djöfla
djól	jól
djölf	djörf
djölful	djöful
djölfulganginn	djöfulganginn
djörfr	djörf
djúðivogur	Djúpivogur
djúðt	djúpt
djúður	djúpur
djukt	mjúkt
djúp	djúp
djúpabík	Djúpavík
djúpavogur	Djúpivogur
djuppur	djúpur
djúppur	djúpur
djúpsina	djúpsigana
djúpsinar	djúpsins
djúpsteikingur	djúpsteikir
djupt	djúpt
djupur	djúpur
djur	dyr
djus	djús
djut	djúpt
djút	djúpt
dkert	skert
dkiptir	skiptir
dkóginum	skóginum
dlætin	lætin
dlatar	flatar
dlíf	líf
dljóður	ljóður
dloðs	loðs
dlortana	lortana
dlotnara	lotnara
dlugeld	flugeld
dnasa	dansa
dner	der
dný	ný
do	dó
dód	dós;dót
doðani	doðni
döðla	daðla
dödlu	döðlu
dödlur	döðlur
does	des
dœtra	dætra
dofanði	dofnaði
dófi	sófi
doflið	dofið
döfuna	döfina
döggvu	döggu;dögg
dögnar	dögunar
dogs	doggs
dógum	dóum
dögurðuf	dögurður;dögurðum
dóis	dós
dók	tók
dök	dökk
dókbrún	móbrúnn;dökkbrúnn
dokbrúnn	dökkbrúnn
dókbrúnn	móbrúnn;dökkbrúnn
dokini	dokinni
dokjtor	doktor
dokkbrún	dökkbrún
dokkbrúnn	dökkbrúnn
dókkbrúnn	dökkbrúnn
dökkhær	dökkhærð
dökkhærd	dökkhærð
dókkhærður	dökkhærður
dökkhærđur	dökkhærður
dókkt	dökkt
dökkust	dökku;dekkst
dökt	dökkt
döl	söl
døl	díl
dólara	dólar
dolari	dollari
dolaro	dolar
dólgr	dólgar;dólgur
dolluni	dollunni
dollý	doll
døma	dæma;dóma
dómarin	dómarinn
domasa	domsa
dómgreinar	dómgreindar
dómgreint	dómgreind
dóminik	Dóminíku;Dóminíka;Dóminíki
dómis	dæmis;dómi
dóm­leg­ar	dómlegar
dómnumur	dómnum
dómorð	dómsorð
dómr	dómur
domsas	domsa
dómssaæ	dómssal
dómstólll	dómstóll
dömsum	dönsum
döna	dóna
dónárósar	Dóná;árósar
dönk	dönsk
dönka	dökka
dönmörk	Danmörk
dönmorku	Danmörku
donner	dottnir
dönska	danska;dönsku
döpa	döpur;dapra
döpan	döpin
dópis	dópi
dopóttur	doppóttur
döpp	döbb
doppótur	doppóttur
döppu	möppu;doppu
döpu	döpur
döpuð	döpur
dör	för
dorena	dárana
dórey	þórey
dorgaðið	dorgaði
dóríð	dótið
dóróthe	Dóróthea;Dórótea
dörra	derra;darra
dorriana	dorrana
dorris	doris
dörrs	dörr
dörrt	dörr
dorsa	forsa
dos	dós
dösa	dísa;dósa
dósað	dúsað
dósaði	dúsaði
dósanum	dósunum
dósbil	dósir
dóséðann	óséðan
dósi	dósin
dösi	desi
doskist	dorskist
dóskist	óskist
döskist	dönskust
dóstæki	dómtæki
döstu	föstu
dösu	dösuð
dosum	dósum
dósur	dósir
dot	dót
dotír	dottir;dóttir
dótit	dóti;dóttir
dotlu	dollu
dótóm	dótum
dotru	motru
dótta	dóta
dottari	dottaði
dótter	dóttir
dóttið	dottið
dottiír	dottir
dottír	dóttir
dóttír	dóttir
dòttir	dóttir
dóttir.	dóttir
dóttirdætur	dótturdætur
dóttiri	dóttir
dóttri	dóttir
dótttir	dóttir
döttur	dóttur
down	don
döxar	öxar
dpreyta	spreyta
dpyrja	spyrja
drá	frá
draa	draga
draði	daði
dræði	ræði
dræfer	dreifir
dræfið	dreifið
drægna	drægni
dræki	drægi
drær	dræm
dræsja	dræsa
dræst	fræst
dræur	dræsur
dræver	frævar
drafans	draflans
drafnana	drafnanna
dragbýtur	dragbítur
drakka	drekka;dralla
drakt	dragt;frakt
drálinn	dregilinn
drám	dræm;rám
dramamynd	draumamynd
dramantískur	dramatískur
dramatisk	dramatísk
dramatíslur	dramatískur
dramatúrgur	dramatúrg
drammatisk	dramatísk
drammatísk	dramatísk
drammatískur	dramatískur
drammt	rammt
dramur	draumur
drán	rán
drangáll	dragmáll
drángur	drangur
drápð	dráp;drápið
drapni	draupni
drápp	dráp
dras	drasl
drásaði	rásaði
drásaðir	rásaðir
drasið	draslið
drasil	drasl
draslan	druslan
draslegt	draugslegt
drasll	drasl
drastist	draslist
drastl	drasl
drastll	drall
drastlyst	draslist
dráttavél	dráttarvél
drátthag	drátthagur
draugasendingu	draugsendingu
draugina	draugana
drauglegur	draugalegur
draugr	draugar
draugue	draugur
draumakenndur	draumkenndur
draumari	draumar
draumir	draumur
draumni	draumi
draumóri	draumóra
draumq	draum
draumsoley	draumsóley
draumu	draumur
draumveröld	draumaveröld
draunma	drauma
draupur	draumur
drausina	trausina
drausu	dausu
drð	dýrð
dreaga	draga
dream	drepa
dreamir	dreymir
dreamt	dreymt
dreasa	dressa
dreck	drekk
dreek	drekk
drefa	dreifa
drefiðist	dreifðist
dreft	dreift
drefta	drifta
dreftu	dreptu
drehmir	dreymir
dreida	dreifa
dreifðbýl	dreifbýl
dreifðbýla	dreifbýla
dreifni	dreifi
dreiftir	dreifir
dreigin	dregin
dreimal	dreyma
dreingurinn	drengurinn
dreio	dreif
dreirauður	dreyrrauður
dreitu	dreistu
drek	drekk;dreki;drep
drekkans	drekans
drekkka	drekka
drekkq	drekk
drekks	drekka
drekkuð	drekka
drellfínn	drellinn
dremja	fremja
drén	trén;dren
drenast	drepast
drengq	dreng
drengue	drengur
drengurin	drengurinn
drengut	drengur
dréni	dreni
drepa;	drepa
drepað	drepa
drepaðar	drappaðar
drepaðir	dropaðir
drepari	dræpari
dresden	dressin
dreyæa	dreyma
dreyfa	dreifa
dreyfbýli	dreifbýli
dreyfbýlt	dreifbýlt
dreyfi	dreifi
dreyfing	dreifing
dreyfingu	dreifingu
dreyft	dreift
dreymdir	dreymir
dreyms	dreyma
dreyngur	drengur
dreyrauður	dreyrrauður
dreyt	dreymt
dreytt	breytt
drfía	drífa
driða	friða
driefbýli	dreifbýli
drífast	þrífast
driftkraft	drifkraft
dríg	drýgi
dríga	drýgja
drígðu	drýgðu
dríifa	drífa
dríja	drífa;drýgja
drík	frík
drikk	drykk
dríkk	drykk
drikka	drekka
drikker	drykkir
drikki	drykki
drikkna	drukkna
dríkkur	drykkur
drillaðs	dillaðs
drillun	drulluna
drink	drykk
dripl	tripl
dripla	tripla
dripplaði	droppaði
drír	frír
drísildjöfull	drýsildjöfull
driver	drifverk
dróa	dró;dróna
dröfta	drifta
drófu	drífu
drog	drög
drógst	dróst
drógt	dróst
drói	dróni;frói
drökk	dökk
drókst	dróst
dröktum	drögtum
dról	dró
dromma	tromma
droms	drums
drönn	hrönn
drópa	dropa
dropandi	droppandi
drös	drós
drótning	drottning
drotníngarlega	drottningarlega
drôtt	drátt
drótting	dróttin;drottning
drottinga	drottninga
drottingu	drottningu
drottinnn	drottinn
dróttna	drottna
drottninf	drottning
drottninginn	drottningin
drottnining	drottning
drrekka	drekka
drúa	trúa
druðust	durðuðust
drufsuna	rufsa
drug	drög
drúgrar	drjúgrar
drúid	drúida;drúidi
druk	drukk
drukkaður	drukknaður
drukkandi	drukknandi
drukna	drukkna
druknaði	drukknaði
drulisil	drusil
drullst	drullast
drunað	dunað
drúngalegt	drungalegt
drunkaði	drungaði
drunkið	drukkið
drunkinn	drukkinn
drunkkaði	drukknaði
drwgur	dregur
drwkka	drekka
drycka	drykkja
drýfa	drífa
dryfknúinn	drifknúinn
drýgari	drýgri
drýgrar	drýgra;drjúgrar
dryja	drýgja
dryka	drykkja
drýkk	drykk
drykka	drykkja;drekka
drykkar	drykkjar
drykkfeldur	drykkfelldur
drykkjarra	drykkjaðra
drykkjarri	drykkjaðri
drykkjarsjálfsali	drykkjasjálfsali
drykkjavara	drykkjuvara
drykkjavörur	drykkjuvörur
drykkjurövl	drykkjutöl;drykkjuröfl
drykkr	drykkur
drýna	rýna
dryrar	dyrnar;dýrar
dryslur	druslur
dryti	bryti
dryykur	drykkur
dsetja	setja
dsga	daga
dsikur	diskur
dskur	diskur
dstofnun	stofnun
dtaða	staða
dtelpur	stelpur
dteypa	steypa
dtofn	stofn
du	dug
dúagi	dúa;agi;dagi;dugi
duatt	datt
duð	suð
dúðari	dúðaðri
dudleg	dugleg
dúðm	dúðum
dúf	dúfa
düfa	dýfa;dúfa
dúfs	dúfa
dúft	duft
duftara	duftar
dugars	dugar
dugg	dögg;dygg;rugg
duggði	dugði
duggilegur	dyggilegur
duggnaður	dugnaður
duggue	duggu;duggur
duggun	duggu;dugguna
duglegúr	duglegur
duglegut	duglegur
dugli	duli
duglir	dulir
duglist	dulist
dugnaðir	dugnaður
dugu	dugi;sugu
dugun	dögun;duga
dúkan	dúkkan;dúka
dúkk	dúk
dukka	dúkka
dukki	sukki
dúklagningamaður	dúklagningarmaður
dúklögn	dúklögð;dúklagning
dukta	dikta
duktaða	diktaða
dularfult	dularfullt
dularfut	dularfullt
dúlarfyllst	dularfyllst
dúlarfyllstur	dularfyllstur
dulargerfið	dulargervið
dúlbúa	dulbúa
dulða	dula;dulda
dulegeur	duglegur
duleglur	duglegur
duleglut	duglegur
dulegur	duglegur
dulg	dug
dulgegur	duglegur
dúlgervi	dulargervi
dulgevri	dulargervi
dull	dul
dullarfull	dularfull
dullarfullt	dularfullt
dullarfullur	dularfullur
dullarfult	dularfullt
dúllarnir	dallarnir
duln	dulin
dúlsma	dúsa
duluarfullur	dularfullur
dulúðlegum	dulúðugum
dulúlðlegum	dulúðugum
dulunna	duluna
dulunnað	dulunnar
dulus	dulu
dulut	dulu;dulur
dulva	dula
dúm	dóm
dumastar	dumbastar
dúnaður	búnaður;rúnnaður
dunða	dunda
dungi	drungi
dunia	duna
dúnin	dúninn
dúnina	dúna;rúnina
dúnir	búnir;fúnir
dúnka	dunka
dunkara	dunkar
dunku	dunkur
dunna	sunna
dunnan	sunnan
dunskur	danskur
dúnt	rúnt
dúnu	dýnu
dúnum	dýnum
dur	dúr
durður	urður
durfa	þurfa;durta
durfð	dirfð
durgir	dugir
durkana	durgana
durki	dunki
durleg	dugleg
durlegur	duglegur
durruð	duðruð
durtann	durta
durtat	durta;durtar
durtir	durtur;þurftir;surtur
durtut	durtur
durum	dyrum
durunum	dyrunum
dus	dús
dusað	dúsað
dusir	dúsir
duskinnu	duskinu
duskist	tuskist
dúskist	dúkist;dúski
dutlungar	duttlungar
dutlungur	duttlungur
duttanir	duftagnir
dúttl	dútl
duúfa	dúfa
dúxannar	dúxanna
dvá	dá;vá
dval›isk	dvalfisk;dvalist
dvana	svana
dvána	dána;vána
dveina	sveina
dveitabænum	sveitabænum
dvelt	svelt
dvíð	Davíð;svíð
dvíði	svíði
dvinar	dvínar
dvínt	dvínað
dvogi	vogi
dvogur	vogur
dvoldið	dvolið;dálítið
dvöldið	kvöldið;dvölduð
dvölun	dvölin
dvpna	dvína;vopna
dxá	dá
dy	dý;dyr;dyl;dyn
dýan	dýnan
dýe	dýr
dyf	dyr
dyfflini	dyflinni
dýfgað	þýfgað;dýpkað
dyfilinn	dyflinn
dyflin	Dyflinn
dýflin	dýfli;dyflinn
dyflini	dyflinni
dýflinn	dyflinn
dygðuður	dygðugur
dygnað	dugnað
dýgrar	dýrar
dyhönd	hönd
dýjur	dylgjur
dykir	þykir
dylfin	dyflinn
dýlið	dýrið
dylinn	dulinn
dylsyt	dylst
dylt	dylst
dymmt	dimmt
dýnam	dýnum;dýnamít
dýnamó	dínamó
dynan	dýnan
dýnar	dýna
dynas	dyns
dynasty	dynastu
dýni	dýnu
dýnnur	dýnur
dýns	dýna
dynu	dýnu
dýny	dýnu
dýpgað	dýpkað
dypi	dýpi
dýpkt	dýpt
dýpk­un	dýpkun
dypri	dýpri
dýpur	djúpur
dyrabjöllinum	dyrabjöllunum
dýrabjöllunni	dyrabjöllunni
dyraböllinum	dyrabjöllunum
dyraböllu	dyrabjöllu
dýraböllu	dyrabjöllu
dyragarður	dýragarður
dýragripa	dýrgripa
dýralæk	dýralækni
dýralæki	dýralækni
dýralæknan	dýralækna;dýralæknar
dyran	dyra
dýrana	dýranna
dýrans	dýran
dýranum	dýrunum
dyrarvörður	dyravörður
dýrasímir	dyrasímar;dyrasími
dyravegur	dyraveggur
dyravernd	dýravernd
dyrð	dýrð
dýrðgripur	dýrgripur
dýrfjöll	dyrfjöll
dyrið	dýrið
dyrindis	dýrindis
dyrinni	eyrinni
dýrins	dýrin;dýrindis
dýrinum	dýrunum;dýrinu
dýrkarður	dýrkaður
dýrkaru	dýrkarðu
dýrke	dýrka
dyrkja	dýrka;Tyrkja
dýrkja	dýrka
dýrlíngadýrkun	dýrlingadýrkun
dyrlur	þyrlur
dyrmættur	dýrmætur
dýrmættur	dýrmætur
dyrmætur	dýrmætur
dyrnaballa	dyrabjalla
dyrnum	dyrunum
dýró	dýr;dró
dýrrá	dýrra
dyrrain	myrran
dýrsla	dýrslega;skýrsla
dýrta	dýrt
dýrteð	dýrtíð
dýrti	dýrt;dýri
dyru	dýru
dýruni	dýrunni
dýryndi	dýrindi
dyryndis	dýrindis
dysa	dysja
dysir	dysjir
dysk	disk
dyskist	dysjist
dýskist	dýrkist
dýskur	þýskur
dýsu	ýsu;dísu
dyt	dyr
dyti	dytti
dýtr	dýr
dyttaður	dyttaðir
dyttanir	dyttaðir
dýu	dýru
dýum	dýrum
dýun	dýnu
dýuni	duni;dýnu;dýnunni
dýunni	dýnunni;dýfunni
dýx	dúx
e9nfalt	einfalt
eæædey	eldey
eafeind	afeind;rafeind
eálsma	sálma
earnir	ernir
east	efast
eatla	atla;ætla
eb	en
ebni	efni
ebólga	bólga;ebóla
ebsonsalt	epsonsalt
éð	að;séð
eda	eða
eðað	eða
eðal	eða
edall	eðall
eðam	eða
eðan	eða
eddda	edda
edðli	eðli
eðe	eða
edic	edit;edik
eðileg	eðlileg
eðileggja	eyðileggja
eðilegur	eðlilegur
eðjana	eðjuna
eðji	steðji
eðjur	keðjur
eðlaða	eðlað
eðlaðana	eðlana
eðlarin	eðlari
eðlilægur	eðlilegur
edlíleg	eðlileg
edlilegt	eðlilegt
eðlílegt	eðlilegt
edn	en
edniđ	efnið
edögg	dögg
edon	don
eðraða	veðraða
eðsta	efsta
eðu	eða;eyðu
eðuð	eruð
eðulsfari	eðlisfari
eðup	eður
edur	eldur
edus	eldis
eðut	eðun;eður
edwars	edwards
edwn	edwin
edyggir	dyggir
eefitt	erfitt
eéi	ei
eein	ein
eellafu	ellefu
eellefu	ellefu
eer	er
eex	sex
efæa	efla
efag	efa;fag
efalítið	efnalítið
efari	efar
efasemdalasu	efasemdalausu
efasta	efast
efat	efa
effað	efað
effan	effa
effar	effa
effaþa	effanna
effita	offita
efiða	erfiða
efina	efins
efingur	fingur
efirnu	ernu
efís	efins
efldug	efldu
eflq	efl;efla
eflu	efla;efli
efnaðin	efnaði
efnafrædingur	efnafræðingur
efnagerðarinar	efnagerðarinnar
efna­hags­bata	efnahagsbata
efnahagshremmingur	efnahagshremming
efnahagslögsaga7	efnahagslögsaga
efnahyggja	efahyggja;efnishyggja
efnan	efna
efnap	efna
efndurheimast	endurheimtast
efndurheimtast	endurheimtast
efnid	efnið
efniđ	efnið
efniðustu	efnuðustu
efnifræði	efnafræði
efniskortur	efnisskortur
efniþig	efnið
efnrænn	einrænn
efriðar	erfiðar;friðar
efriðleikar	erfiðleikar
efriður	friður;erfiður
efstuna	efstu
eftifarandi	eftirfarandi
eftiminnanleg	eftirminnileg
eftirdagum	eftirdrögum
eftirfarandu	eftirfarandi
eftirgrenslan	eftirgrennslan
eftirlátsemi	eftirlátssemi
eftirlítsins	eftirlitsins
eftirmidagur	eftirmiðdagur
eftirminnanleg	eftirminnileg
eftirminnanlegur	eftirminnilegur
eftirminninleg	eftirminnileg
eftirrétur	eftirréttur
eftirsóknaverð	eftirsóknarverð
eftirspurning	eftirspurnin
eftirvænt	eftirvænting
eftirvæntingafull	eftirvæntingarfull
eftit	eftir
eftivænting	eftirvænting
eftrilit	eftirlit
eftsáð	efsað
efur	hefur
efx	ef
eg	ég
èg	ég
ega	eiga
egand	egnd
egðu	segðu;legðu;leggðu
egér	er
egga	eggja
eggil	eggi
egginn	eggin
eggjabaka	eggjabakka
eggjahrær	eggjahræru;eggjahræra
eggjalíkör	eggjalíkjör
eggjastökkur	eggjastokkur
eggjastokum	eggjastokkum
eggjastokur	eggjastokkur
eggju	eggjum
eggjukaka	eggjakaka
eggjuköku	eggjaköku
eggkaka	eggjakaka
eggukaka	eggjakaka
egilaataðir	Egilsstaðir
egilastaðir	Egilsstaðir
egillson	Egilsson
egillst	Egill
egillstaðir	Egilsstaðir
egilsstaður	Egilsstaðir
egilsstöðum	Egilsstöðum
egin	eigin
eginmaður	eiginmaður
eginn	einn;enginn;eiginn;eigin
egir	segir
egír	gír
egj	egg
egjakaka	eggjakaka
egló	eygló
egnað	egna;eignað
egnandist	egndist
egsalat	salat;eggjasalat
egsif	sif
egyfskur	egypskur
egypst	egypskt
egypt	Egypta;Egypti
egyptist	Egypti
egyptland	Egyptaland
ehausa	hausa
ehitta	hitta
ehverju	hverju
éi	ég
ei.	ei
eiað	eimað
eiaga	eiga
eibkynn	eikinn
eid	ei
eiðaðir	siðaðir
eiðas	eiðs
eiddi	eyddi
eiðilega	eyðilega
eiðilegga	eyðileggja
eiðileggja	eyðileggja
eiðíleggja	eyðileggja
eiðist	eyðist
eidn	einn
eiðrétta	leiðrétta
eiðyr	eiður
eifa	eyfa;eiga
eifi	eyfi
eifiður	erfiður
eifnifall	nefnifall
eigaa	eiga
eigadagur	sigadagur
eigaði	eignaði
eigah	eiga
eigandanna	eigendanna
eigandur	eigendur
eiganleg	eiginleg;eiguleg
eigann	eiga
eigar	eiga
eigarst	eigast
eigða	eygða
eigði	eygði;eigi
eigeindur	eigendur
eigendanna.22	eigendanna
eigenður	eigendur
eigenlega	eiginlega
eigia	eiga;eigi
eigill	Egill
eigindann	eiginmann;eigandann
eigingjan	eigingjarn
eiginhandaráritum	eiginhandaráritun
eiginjn	eiginn
eiginleik	eiginleika;eiginleiki
eiginm	eigin
eiginmaðuer	eiginmaður
eiginman	eiginmann
eiginnmaður	eiginmaður
eiginst	eigin;eignist
eigjosep	Jósep
eigll	Egill;Eygló
eiglo	Eygló
eigló	Eygló
eiglö	eigli;Eygló
eignanðist	eignaðist
eignarfornaf	eignarfornafn
eignarfornö	eignarfornöfn
eignarskemmdir	eignaskemmdir
eigna­spjöll	eignaspjöll
eignig	eining;eigni
eigon	eigin
eigrast	veigra;eigast
eihvað	eitthvað
eihverja	einhverja
eihvern	einhvern
eii	eigi;ei
eiíft	eilíft
eiiga	eiga
eiill	egill
eiithver	eitthvert;einhver
eij	ey
eija	eyja
eikatré	eikartré
eikfad	eirfat;eitthvað
eikfað	eitthvað
eikia	eikina
eikionni	eikinni
eikk	eik
eikst	eykst
eiktan	veiktan
eiktu	leiktu
eiktur	eitur;eyktar
eiku	eik
eilæifðina	eilífðina
eild	deild
eilífðona	eilífðina
eilífina	eilífðina
eilífinna	eilífðina
eilifu	eilífu
eílifu	eilífu
eílifur	eilífur
eiligur	einlægur;eilífur
eilítt	eilíft
eilíu	eilífu
eillífðina	eilífðina
eilýfð	eilífð
eimaðast	eimaða
eimsli	eymsli
eimsu	eimu
einaborg	eignaborg
einagranir	einangraðir;einangranir
einangranir	einangraðir;einangranir
einangrunstöð	einangrunarstöð
einangunn	einangrun
einaraður	einarður
einarein	akrein;einar
einars,	einars
einbæta	einbeita
einbeintingu	einbeitingu
einbeintinngu	einbeitingu
einbeitingur	einbeitingu
einbeitinngur	einbeitingar
einbeitningarörðuleikar	einbeitingarörðugleikar
einbet	einbeit
einbett	einbeitt
einbeytingur	einbeitingar
einbeytnig	einbeiting
einbeytnina	einbeitnina
einbeytning	einbeiting
einbeyttur	einbeittur
einblað	einblaða
einblæymum	einblínunum
einblina	einblína
einblínd	einblínt
einblöðungunm	einblöðungunum
einblöðunum	einblöðungum
einblýna	einblína
einbylishús	einbýlishús
einbylíshús	einbýlishús
einbýll	einbýli
einbýlt	einbýli
eindagu	eindagi
eindalt	einfalt
eindi	erindi
einelik	einleik
einfala	einvala
einfald	einfalt
einfalða	einfalda
einfalðad	einfaldað
einfalðan	einfaldan
einfálðan	einfaldan
einfaldanir	einfaldaðir;einfaldanir
einfalfur	einfaldur
einfaltt	einfalt
einfdagi	eindagi
einfeld	einföld;einfeldni
einfeldnislegt	einfeldningslegt
einfeldnislegur	einfeldningslegur
einfeldur	einfaldur
einflad	einfalda
einfladari	einfaldari
einfladur	einfaldur
einfleypur	einhleypur
einföldrum	einföldum
einfunn	einkunn
eing	ein
eingandi	eigandi
eingann	engan
eingarfornöfn	eignarfornöfn
eingaskattur	eignaskattur
eingaungu	eingöngu
eingerð	meingerð
eingileiki	eiginleiki
eingin	engin
einging	eining
einginhn	enginn
einginlega	eiginlega
einginleiki	eiginleiki
einginn	enginn
eingöngun	eingöngu
eingra	engra
eingundur	eigendur
einhever	einhver
einhjerjir	einhverjir
einhljóđ	einhljóð
einhugiö	einhugi
einhva	eitthvað
einhvað	eitthvað
einhve	einhver
einhvee	einhver
einhvem	einhver;einhverjum
einhverhnnn	einhvern
einhverj	einhverjir;einhverjum
einhverjur	einhverjir
einhverru	einhverju
einhversis	einhvers
einhvert	eitthvert
einhverunni	einhverfunni
einhvr	einhver
einhvrer	einhver
einhvurslag	hvurslags
einhvurslags	hvurslags
einiberjarunn	einiberjarunni
einiberjarunnur	einiberjarunnar
einiingum	einingum
einin	eini;eining
einind	eining
einingamálum	peningamálum
einingarlaus	meiningarlaus
eininginun	einingunum;einingin;eininguna
eininginuna	einingin;eininguna
einisdótt	Einisdóttir;Einisdóttur
einjbert	einbert
einkab	einkar
einkaðu	seinkaðu
einkanni	einkenni
einkannir	einkunnir
einkavæg	einkavæða
einkavæga	einkavæða
einkend	einkennd
einkenne	einkenni
einkr	eink;einkar
einku	einkum;einkunn
einkumn	einkum;einkunn
einkun	einkunn
einkunm	einkum;einkunn
einkúnn	einkunn
einkunnaorð	einkunnarorð
einkunnarbók	einkunnabók
einkunnarkvarði	einkunnakvarði
einkunnarspjald	einkunnaspjald
einkunni	einkunir
einkv	eink
einkvað	eitthvað
einkvern	einhvern
einleiji	einleiti;einleik
einlíd	einlíf;einhlít
einlitaður	einlitur
einllift	einlyft
einm	einmana
einma	einmana
einmaannur	einmananum;einmana
einman	einmana
einmanaá	einmana
einmanaleik	einmanaleiki
einmanna	einmana
eínmanna	vínmanna;einmana
einmannalegt	einmanalegt
einmannalegur	einmanalegur
einmannaleika	einmanaleika
einmannaleiki	einmanaleiki
einmannur	einsannur
einmanur	einmanar
einn,	einn
einnatt	einatt
einnefn	einnefni
einnefning	einnefni
einnfaldan	einfaldan
einnfalt	einfalt
einnfalta	einfalda
einnfaltan	einfaldan
einnhljóð	einhljóð
einnhva	eitthvað
einnhver	einhver
einnhverjar	einhverjar
einning	eining
einnkeni	einkenni
einnkun	einkunn
einnkún	Einrún
einnkunn	einkunn
einnleiða	innleiða
einnot	einnota
einnotur	einnota
einnu	einu;einn
einnvhern	einhvern
einræðni	einræði
einrómur	eintómur
eíns	eins
einsage	einslaga
einsins	einisins
einsker	einskeri
einskin	einskis
einskís	einskis
einskór	einskær
einskörðungar	einskorðunar
einsks	einskis
einskunn	einkunn
einskyn	einkyn
einsletur	einsleitur
einsö	eins
einsömru	einsömu
einsr	eins
einsskys	einskis
einst	eins
einstafa	einstaka
einstakingur	einstaklingur
einstaklingue	einstaklingum
einstaklinur	einstaklingur
einstaktur	einstakur
einstaling	einstakling
einstígur	einstig;einstigi;seinstígur
einstöo	einstök
einsþáttar	einsþátta
eintrjáninn	eintrjáning
einugis	einungis
einuhverju	einhverju
einurðan	einurðin
einurp	einurð
einvaðla	einvala
einvallalið	einvalalið
einverjum	einhverjum
einvhert	eitthvert
einvhörf	einhverf
einvigi	einvígi
einvörðungis	einvörðungu
einvörðúngu	einvörðungu
eipyr	reipi
eirarúno	eyrarúnu
eirarúnr	eyrarúnur
eirarúnur	eyrarúnur
eirik	Eirík
eiríkr	Eiríkur
eiriksonn	Eiriksson;Eiríksson
eiríkssno	Eiriksson;Eiríksson
eíriksson	Eiriksson;Eiríksson
eirikur	Eiríkur
eirikúr	Eiríkur
eiríkúr	Eiríkur
eírikur	Eiríkur
eirnýja	Eirnýjar
eironum	eirunum
eíronum	emírunum;eyrunum
eirra	þeirra
eirsif	eiri
eirukur	Eiríkur
eisara	keisara
eísiða	eiða
eislým	eyslum
eisn	eins
eistalyppa	eistnalyppa
eisteynn	eysteinn
eit	eitt
eithhvað	eitthvað
eithkvað	eitthvað
eithvað	eitthvað
eithvert	eitthvert
eitlefu	ellefu
eitthva	eitthvað
eitthvap	eitthvað
eitthvar	eitthvað
eitthvaü	eitthvað
eitthver	einhver
eitthverja	einhverja
eitthverju	einhverju
eitthvern	einhver
eitthverr	eitthvert
eitthvorn	sitthvorn;eitthvert;einhvern
eitthvsð	eitthvað
eittkvað	eitthvað
eittlefu	ellefu
eitum	einum
eitunn	Eiðunn
eiturlif	eiturlyf
eiturlíf	eiturlyf
eiturt	eitur
eiturverkarin	eiturverkunin
eiusta	eista
eivhern	einhvern
eivör	Eyvör
eívor	ívör;Eivör;Eyvör
eívör	ívör;Eivör;Eyvör
eiþor	Eyþór
eiþór	Eyþór
ejálg	njálg
ejg	egg
ejl	el
ejt	ert
ejyólf	Eyjólf
ekaðu	ektaðu
ekdiviðinn	eldiviðinn
ekeert	ekkert
ekhvað	eitthvað
eki	ekki
ekills	ekils
ekink	eink
ekísabet	Elísabet
ekjuð	ekju
ekkerr	ekkert
ekkir	ekki
ekkisen	ekkisens
ekkj	ekki
ekkkert	ekkert
ekko	ekki
ekkó	ekki
ekkóann	ekkann
ekkóanna	ekkanna
eklá	ekla
eklú	eklu
eknhver	einhver
eko	sko
ekraða	dekraða
eksplóra	eksplódera
ekstur	rekstur
ekynsamlega	skynsamlega
el´li	elli
ela	élja;pela;kela;fela
éla	él;véla
elæda	elda
elamar	Elmar
elamíska	latmíska
elaska	elska
elav	Elva
elbogi	eldbogi
elða	eða
eldabrand	eldibrand
eldabröndum	eldibröndum
eldadi	eldaði
eldanennskunni	eldamennskunni
eldarvélarhella	eldavélarhella
elddavélin	eldavélin
eldest	eldast
eldfjol	eldfjöll
eldfjól	eldfugl
eldfjqll	eldfjöll
eldfkall	eldfjall
eldgósin	eldgosin
eldh-us	eldhús
eldhsús	eldhús
eldhus	eldhús
eldhusid	eldhúsið
eldhusinu	eldhúsinu
eldhusínu	eldhúsinu
elðivið	eldivið
eldivíður	eldiviður
eldjarn	eldjárn
eldka	elska
eldmél	eldvél
eldon	eldun
eldraugt	eldrautt
eldraukt	eldrautt
eldro	eldri
eldsbjarmanum	eldbjarmanum
eldsemma	eldsnemma
eldsneiti	eldsneyti
eldsnejta	eldsneyta
eldsnejti	eldsneyti
eldspöytur	eldspýtur
eldspýytur	eldspýtur
eldstu	elstu
eldstur	elstur
eldsúd	eldsúr
eldu	eldur
eldurbrandur	eldibrandur
eldúsinu	eldhúsinu
elektrón	elektróna
elektroni	elektrónu
elena	Elena
elexís	elexírs
elexíss	elexírs
elf	ef
elfut	elfu
elggja	leggja
elgosin	eldgosin
eli	Elí
elï	el;Elí
elía	Elín
elíabet	Elísabet
elið	leið
elífð	eilífð
elífðina	eilífðina
elin	Elín
elina	eina
elindís	Eindís
elínósk	Elín;ósk;Ósk
elîs	Elís
elisa	Elísa
elísa	Elísa
elísabe	Elísabet
elisabet	Elísabet
elísabet	Elísabet
elísarbet	Elísabet
elkaðu	elskaðu
elkem	Ellen
elkominn	velkominn
ellafu	ellefu
ellding	elding
ellen	Ellen
elliðárnar	elliðaárnar
ellinii	ellinni
ell­inni	ellinni
elly	Ellý
eln	en
elnbogi	ölnbogi;olnbogi
elniviður	efniviður
eloda	elda
eloís	Elís
elos	los
elplum	eplum
elsavél	eldavél
else	Elsie
elsebet	Elsabet
elsebeth	Elisabeth
elshus	melshús
elskandur	elskendur
elskann	elskan
elskendu	elskendur
elsvoði	eldsvoði
eltaðar	eldaðar
elva	Elva
elvar	Elvar
elvi	eldi
elvurna	evruna
elztur	elstur
emann	mann
embæti	embætti
emblaýr	Embla;Ýr
emda	enda
emeliana	Emelíana
emelie	Emelía;Emilía
emilía	Emilía;Emelía
emiliana	Emilíana
emilý	Emil;Emilía
emjana	emjanar
emjanan	emjanin
emjast	lemjast
emmarnað	emmanna
emmnaðar	efnaðar
emnding	ending
empj	emj
emstru	emstrur
emta	meta
én	en
enar	einar
enarða	einarða
end	endi
endalangur	endilangur
endalegt	endanlegt
endalsut	endalaust
endalus	endalaus
endan	endann
endanleikinn	óendanleikinn
endanm	endanum
endarfarmi	andarfari
endarlega	endanlega
endarþar	endaþarm
endarþarm	endaþarm
endarþarmur	endaþarmur
endastaður	endastæður
endaþarmne	endaþarmi
endelig	endileg
endenn	endann
endenum	endanum
endiir	endir
endina	hendina;höndina
endingur	endingu
endistu	endist
endlaus	endalaus
endlausa	endalausa
endlaust	endalaust
endq	enda
endrar	endar
endst	endast
endugerð	endurgerð
endugreitt	endurgreitt
endurævingar	endurhæfingar
endureisa	endurreisa
endureisn	endurreisn
endureissa	endurreisa
endurgeiða	endurgreiða
endurgjöd	endurgjöf
endurgjörf	endurgjöf
endurgreida	endurgreiða
endurgreiddandi	endurgreiddan
endurgriett	endurgreitt
endurheima	endurheimta
endurheimtna	endurheimta
endurkastari	endurkastar
endurkrefja	endurkrafa
endurlæra	endurnæra
endurlitun	endurritun
endurmentun	endurmenntun
endurmentunn	endurmenntun
endurnir	endurnar
endurnýinga	endurnýtingar
endurnýingar	endurnýtingar
endurnýji	endurnýi
endurnýjingar	endurnýjungar
endurnyjun	endurnýjun
enduro	endur
endurreissa	endurreisa
endurskoðu	endurskoðun
endurskynsmerki	endurskinsmerki
endurtaa	endurtaka
endurteikning	endurtekning
endurtekningur	endurtekningar;endurtekning
endurvinnand	endurvinnandi
endyrnýja	endurnýja
endyrnyjun	endurnýjun
endyrnýjun	endurnýjun
ene	en
eneas	enea
eneliana	Emelíana
eneygðan	eineygðan
enfald	einföld
enfaldur	einfaldur
engann	engan
engðist	entist
engdur	tengdur
engelbert	Engilbert
engilsaxnes	engilsaxnesk
engimm	enginn
enginj	engin
enginng	enginn
enginnh	enginn
enginnn	enginn
enginur	enginu
engjan	engan
englan	engan
engo	engu
engonn	enginn
engsins	engisins
engur	lengur
engvan	engan
enign	engin
enihver	einhver
enkamál	einkamál
enkunn	einkunn
enmginn	enginn
enndalegur	endanlegur
enngin	engin
enning	menning
enninnu	enninu
ennn	enn
enntið	ennið
enntuð	menntuð
ensíll	pensill
enskaa	enska
enskann	enskan
ensog	innsog
enssh	ensk
ensu	ensku
ensuð	enskuð
entan	engan
entire	lentir
entuð	lentuð
enuð	eruð
enudnýja	endurnýja
enun	enn
enþa	enda
eöflugur	öflugur
eöflugurggert	öflugur;gert
eokna	ekna
epð	eð
epeð	peð
epelsina	epilsins
epflaust	eflaust
epi	epli
epíkúrismi	epikúrismi
epillur	pillur
epilsina	epilsins
eplað	eplið
eple	epli
eplikaka	eplakaka
eplimakuk	eplamauk
eplimauk	eplamauk
eplisafa	eplasafa
epni	efni
epotturða	spottyrða
eppelsina	appelsína
eppli	epli
epplí	epli
epst	efst
eptlið	eplið
ér	er;ég;sér
era	er;vera
erartröð	eyrartröð
erðagreining	verðaðgreining
erðan	gerðan
erðataska	ferðataska
erðfafjendur	erfðafjendur
erðigur	verðugur
erðna	erna
erðu	eru
erendi	erindi
erendur	erlendur;Erlendur
erengum	erindum
eresi	aresi
erfðarfjendur	erfðafjendur
erfid	erfið
erfiđ	erfið
erfiđur	erfiður
erfídur	erfiður
erfíður	erfiður
erfigur	erfiður
erfileika	erfiðleika
erfileikar	erfiðleikar
erfileiki	erfiðleiki
erfit	erfitt
erfittur	erfitt
ergan	engan
ergels	ergelsi
ergiðs	ergðs
erglind	Berglind
erhiður	erfiður
eri	er
erið	verið;kerið
eridi	erindi
erifiðleiki	erfiðleiki
erikssónur	Erikssonar
erin	ein
eringdi	erindi
erinid	erindi
erir	gerir
erjaru	erjarðu
erka	reka
erkaðar	verkaðar
erkefnið	verkefnið
erklýðsríki	verklýðsríki
erlandra	erlendra
erldurinn	eldurinn
erledur	erlendur
erleendur	erlendur
erlindi	erindi
erlinsson	Erlingsson
ermaðan	armaðan
ermasund	Ermarsund
ermist	fermist
ernað	erna
ernalokka	eyrnalokka
ernirn	ernir
ernjr	ernir
ernnum	erninum
ernuö	Ernu
eron	Aron
erós	rós;Rós
erraða	þerraða
ers	er
ertat	ertast
ertðu	ertu
ertirinn	ertarinn
ertunn	ertunni
eruþ	eru
erv	er
ervit	örvit
erygló	Eygló
esekiel	Esekíel
esjað	Esja
eskjufjörður	Eskifjörður
eskti	æskti
eslkar	elskar
espen	espan
esr	er
essínu	essinu
estr	Ester
estrasalt	Eystrasalt
estríð	stríð
estriður	stríður
estríól	stríðól
estrun	eitrun
estu	mestu
etæk	tæk
etanol	etanól
eteranna	esteranna
eterni	eternit
etfitt	erfitt
ethanol	etanól
ethvað	eitthvað
etíða	etýða
etilýn	letilýð
etjuð	etjið
etkvað	atkvæð;eitthvað
etla	ætla
etlefu	ellefu
etr	er
etsent	sent
etterni	ætterni
ettlefu	ellefu
etvöfaldur	tvöfaldur
euddi	eyddi
euro	eru
eurt	ert
eurun	eyrun
euyra	eyra
evangeliskur	evangelískur
evau	Eva
eve	Eva
evgeniy	Evgeníu
evið	við
eviðhorfum	viðhorfum
evripsk	evrópsk
evropskur	evrópskur
evrópu	Evrópu
evrópubú	Evrópubúa
evrópumæot	evrópumót;Evrópumót
evrópuráð	Evrópuráðið
evr­ópuþing­inu	Evrópuþinginu
exaðirs	pexaðs
exarðu	rexarðu
exaru	rexarðu
exat	exa
exist	pexist
exmu	emmu
exnað	efnað
exnoni	eroni
expesjónismi	expressjónismi
expessjónismi	expressjónismi
exploru	export
expressíonismi	expressjónismi
exr	er
exss	ess
extaði	textaði
exun	exin
eý	ey
eya	eyja
eyberf	eyberg
eyda	eyða
eyđa	eyða
eyðaileggja	eyðileggja
eyðda	eyða
eyððu	eyðu
eyðe	eyða;eyði
eyðibðli	eyðibýli
eyðilagð	eyðilagði
eyðilegginga	eyðileggingar
eyðileggjad	eyðileggja
eyðilegja	eyðileggja
eyðilegst	eyðileggst
eyðimerk	eyðimörk;eyðimerkur
eyðisk	eyðist
eyðja	eyða
eyðjaat	eyðast
eyðlegging	eyðilegging
eydnan	eyddan
eyðniða	eyðniði
eyðq	eyð;eyða
eyðrunar	eyðurnar
eyðslupúkin	eyðslupúkinn
eyðt	eyð
eyðuð	eyðu
eyđur	eyður
eyes	ees
eyeun	eyrun
eyfh	eyfi
eyfirzkra	eyfirskra
eygjló	eygló
eygjuna	eyjuna
eyglo	eygló
eyjafjaðrar	eyjafjarðar
eyjandi	deyjandi
eyjar&	eyjar
eyjara	eyjar
eyjarfjarðar	eyjafjarðar
eyjarinnae	eyjarinnar
eyjaskegg	eyjaskeggi
eyjaskeggyr	eyjaskeggi
eyjolfur	Eyjólfur
eyjq	eyju
eyjsa	eyja
eyjsaa	eyjanna
eyjverskur	eyverskur
eykti	reykti
eykun	eykur
eylíf	eilíf
eylífð	eilífð
eylífðin	eilífðin
eylífðina	eilífðina
eyls	eys
eylsir	eilsir
eymæð	eymið
eymas	eymars
eymslu	geymslu
eymti	eymi
eymuð	eimuð
eynalokka	eyrnalokka
eynalokkur	eyrnalokkur
eynarlokka	eyrnalokka
eynna	eynni
eyns	eins
eynskins	einskis
eypskur	egypskur
eyr	eyri;eir;er;aur
eýr	er;rýr
eyrikur	eyríkur
eyrnalrokkar	eyrnalokkar
eyrnarlokk	eyrnalokk
eyrnarlokka	eyrnalokka
eyrnarlokkarnir	eyrnalokkarnir
eyrnarlokki	eyrnalokki
eyrnarpinni	eyrnapinni
eyrnarsnepill	eyrnasnepill
eyrnarverkur	eyrnaverkur
eyrnuð	seyrnuð
eýronum	eyrunum
eyrq	eyra
eýrun	eyrun;Eyrún
eýrún	Eyrún
eysís	Eydís
eyskinn	feyskinn
eysteinm	Eysteinn
eystrasta	eystra
eystuð	leystuð
eystun	eistun
eysuni	peysunni
eyunni	eyjunni
eyunum	eyjunum;eyrunum
eyur	eykur
eyv7ndur	Eyvindur
eyvindu	Eyvindur
eyvinfur	Eyvindur
eyvitar	eyvistar
eyvòr	Eyvör;Eivör
eyxna	eyrna
eþanol	etanól
eþíopar	Eþíópar
eþíopísk	eþíópísk
eþíópiska	eþíópíska
eþíópska	eþíópíska
eþó	þó
eþrenna	þrenna
f-olk	fólk
f)prjóna	prjóna
f´ekk	flekk
f´otbolta	fótbolta
f´r	fór
f´ra	fara
f´stra	fóstra
f0önk	pönk;fönk
f0studagur	föstudagur
f0t	föt
f3k	fok
f8ngur	fingur;fengur
fa	fá;af
fà	fá
fa.ta	fata
faa	fara;fata;faga
fäa	fáa
faaðir	faðir
fáænar	fáeinar
fáauni	fáandi
fáb	fá
fabbrikuni	fabrikkunni
fabína	fabían
fábja	fáa
fábreytnislegu	fábreytilegu
fac	fas
fada	fasa
fader	faðir
fadi	fasi
faði	faðir
faðie	faðir
faðír	faðir
faðiramma	föðuramma
faðirr	faðir
faðjanna	faðmanna
faðjur	faðmur
fáðjur	fáður
faðmalag	faðmlag
faðman	faðma
faðmann	faðminn;faðma
faðmin	faðminn
fadór	Valdór
faðor	faðir
faðra	fara;feðra
faður	faðir;maður;föður
faðúr	faðir
fadurinn	faldurinn
fádurinn	fákurinn
fæa	fá
fæðð	færð
fæddann	fæddan
fæddast	fæddist
fæddis	fæddist
fæðður	færður
fæðgi	fæði
fæðingablettur	fæðingarblettur
fæðingafræði	fæðingarfræði
fæðingalæknir	fæðingarlæknir
fæðingaranar	fæðingarnar
fæðingarfdeild	fæðingardeild
fæðingingar	fæðingarinnar
fæðingunar	fæðinguna
fæðispenna	fæðispeninga
fæðni	færni
fæður	færður
fæeir	færir
fæelagsleg	félagsleg
fægji	fægi
fægrur	fægður
fáeignir	fáeinir
fæinar	fælnar
fáeinif	fáeinir
faeinir	fáeinir
fáeinis	fáeinir
fáeinm	fáeinum
fáeinn	fáein
fáeinu	fáeinum
fáeitt	fáein
fæji	færi
fækkurnar	fækkunar
fælra	færa
fæminna	væminna
fæminsta	féminnsta
fær7	fær
færajar	Færeyjar
færann	færan
færask	færast
færðispening	fæðispeninga
færey	Frey;Færeyjar
færeyjingi	Færeyingi
færeyuna	Færeyinga
færg	fær
færgum	færum
færgumm	færum
færlsa	færsla
færsluni	færslunni
færstla	færsla
fæs	dæs
fæstla	fæsta
fæstrau	fæstra
fæstrauð	fæstrar
fæt	fær
fætun	fætur
fæturr	fætur
fætutnir	fæturnir
fæyreskur	færeyskur
faf	af
fafa	afa;faga
fáfar	fáar
fáfara	fáfarna
fáfarar	fáfarnar
fáfengi	áfengi
fáfengið	áfengið
fafi	afi
fafs	gafst;afa
fagaðil	fagaðili
fágang	frágang
fágari	fágaðri
fagg	flagg;fag
faggir	flaggir
faggr	fagur
faggur	fagur
faginni	fanginni
fagllegur	faglegur;fallegur
fagmennskja	fagmennska
fagmensku	fagmennsku
fagnaðarerindinum	fagnaðarerindinu;fagnaðarerindunum
fagnaðarkend	fagnaðarkennd
fagnafundr	fagnafundur
fagnarlæti	fagnaðarlæti
fagnaü	fagna
fagnaüi	fagnaði
fagnq	fagn
fagnur	fagnar;fagnir
fagný	fagna;dagný
fagót	fágæt;fagott
fagr	fagur
fagrio	fagri
faguðum	fáguðum
fágúðum	fáguðum
fague	fagur
fagura	fagur;fagurra
fagurbðokmenntir	fagurbókmenntir
fagurfræðing	fagurfræði
fagurhólmsmýri	fagurhólsmýri
fagurinn	dagurinn
fagut	fagurt;fagur
fagyr	fagur
faha	fara;faga
fahur	fagur
faír	far
fáír	fáir
fairð	farið
fajll	fall
fakan	vakan
fakdurin	faldurinn
fakk	gakk
fakt	vakt
falán	lán
falangist	angist
fálanni	fálunni
falaska	Alaska
falðar	faldar
falði	faldi
faldurin	faldurinn
faldyr	faldur
faleg	falleg
falfur	falur
fáliða	fáliðað
fálinna	falinna
fálitur	fáleitur
fálkanns	fálkans
fálkaorð	fálkaorðu
falkegur	fallegur
fálkur	fálkar
fallað	fjallað
fallaðu	fjallaðu
fallandið	fallandi
fallar	fjallar
fallbeigja	fallbeygja
fallbeiing	fallbeyging
fallbeing	fallbeyg;fallbeyging
fallbeining	fallbeyging
fallbeiningar	fallbeygingar
fallbeyginar	fallbeygingar
fallbeyginbg	fallbeyging
fallbeying	fallbeyging
fallbeyj	fallbeyg
fallbeyjing	fallbeyging
fallbeyjum	fallbeygjum
fallbying	fallbeyging
fallbysunar	fallbyssurnar
fallbysur	fallbyssur
falldi	faldi
falle	falleg
falleg7r	fallegur
fallegara	fallegra
fallegirfallegarfalleg	fallegir;fallegar;falleg
fallegtfallegt	fallegt
falleguer	fallegur
fallegut	fallegur
fallelegt	fallegt
fallengt	fallegt
fallengur	fallegur
falleur	fallegur
fallg	falleg
fallgur	fallegur
falllegr	fallegri;fallegur
fallon	fallin
fallrg	falleg
fallstjor	fallstjórn
fallstjorn	fallstjórn
falltirn	fallinn;fallturn
fallu	falli
falm	fálma
fálmana	fálmara
falmandi	fálmandi
falms	fálma
falrgur	fallegur
fálskir	falskir
falstans	fastans
falsur	faldur
falti	falli;valti
faltkaka	flatkaka
faluta	flauta
famb	lamb
fámeni	fámenni
famið	framið
famistaða	frammistaða
famm	fimm
fammu	fimmu
famsl	framsal
famso	farms
fámso	fáms
fan	fann
fán	fáni
fánd	fund
fandi	fjandi
fandinn	fjandinn
fáneinar	fáeinar
faneny	Fanney
fangav-rður	fangavörður
fánge	fanga
fangealsi	fangelsi
fángelsi	fangelsi
fangelsisvörður	fangavörður
fangelsivistar	fangelsisvistar
fánginn	fanginn
fanginum	fanginu
fanglesi	fangelsi
fanglína	fangalína
fangmarkið	fangamarkið
fangsela	fangselja
fani	fáni
fáńi	fái
fankynfja	vankynja;fannkyngja
fankyngja	fannkyngja
fánleiki	fáanleiki
fanls	fans
fannafod	fannafold
fannan	annan;fanna
fannana	fannanna
fannast	fannst
fanni	fann;danni;Danni
fannry	Fanney
fannt	fannst
fánoi	fáni
fansl	fans
fanst	fannst
fantjr	fantur
fánuar	fánar
fánýtti	fánýti
fanþór	Svanþór
faöir	faðir
fäotur	fontur
fáp	fá
fara¨	fara
farabrodd	fararbrodd
farabrot	fjaðrabrot
farabúa	farbúna
fáraði	fáráði
fáraðu	fáráðu
faragur	farangur
faraladur	faraldur
faraldu	faraldur
faraldyr	faraldur
faraljótir	forljótir
faramanna	varamanna
farand-	farandi
farands	farlands
farandssögur	farandsögur
fáranleiki	fáránleiki
farannar	fararinnar
faraói	faraóa;faraó
farari	fari;fara
fararskjót	fararskjóti
faraskipta	fataskipta
faraskjóti	fararskjóti
farasnið	fararsnið
faratæki	farartæki
faratál	farartálmi
faratala	fara;tala
faratálm	farartálmi
faratálma	farartálma
farateski	farteski
farboða	farborða
farboði	farborði
farðega	farþega
farðegi	farþegi
farðeginn	farþeginn
farðtaska	ferðataska
farðun	förðun
farðþeginn	farþeginn
fare	fara;far
farfáa	farfána
farfbaugur	hvarfbaugur
farfundur	fjarfundur
fargara	fargar
fargari	fargar
fargist	farist
fargistu	fergistu
farina	farin;farinna
faring	farin
farisei	farísei
farlátum	forlátum
farlömu	farlama
farlömuð	farlama
farmáti	fararmáti
farmíða	farmiða
farnur	farnir
farói	fari;faraó
faröldum	faröldrum
farönd	farlönd;farand
farsældir	farsældar
farsælður	farsælum;farsæll
farsælr	farsæll
farsima	farsíma
farsíma	farsíma
farsímann	farsímann
farsími	farsími
fárski	ferski
farst	farast
farstan	fastan
farstans	fastans
farsúmarbústað	sumarbústað
fartalva	fartölva
fartegi	farþegi
farti	fari
fartöflur	kartöflur
fártöl	fjártöl
fartöla	fartölva
fartölann	fartölvan
farvald	faraldur
farvaldur	faraldur
farvera	forvera
farþegan	farþegann
farþegari	farþegar
farþegiáð	farþegi
farþegu	farþegum;farþegi
fasað	dasað
fasaður	fastur
fasat	fast
fasir	fastir
fasíslur	fasískur
faska	flaska
fásku	fástu
fasrur	fastur
fasst	fast
fastaeignamat	fasteignamat
fástan	fastan
fastlaun	fastalaun
fástr	fást
fastreiðnir	fastareiðarnir
fastu	fasti
fasturinn	fastinn
fastus	fastur
fásty	fást
fatabúd	fatabúð
fátækrarlög	fátækralög
fátæl	fátæk
fatahruga	fatahrúga
fatangur	farangur
fataskáð	fataskáp
fataskap	fataskáp
fatasla	fataslá
fátbrotnum	fábrotnum
father	fastaher
fatinnu	fatinu
fatladur	fatlaður
fátǿkra	fátækra
fátöldum	frátöldum
fattinn	fatti;farinn
fattinu	fatinu
fattning	kattning
fátts	fás;fátt
fattta	fatta
fáttuð	fánuð
fauanna	fautanna
faug	fauk
fauknir	auknir
fauku	fauk
fauli	auli
faull	fall
fault	falt
faulur	falur
faumi	flaumi
faumin	frumin;flauminn
fauminn	flauminn
fauni	funi;fáni
fauní	funi;fáni
faurar	gaurar;aurar
fausinni	fausinn
faustans	fautans
fautini	fautinn
fautinni	fautinn;lautinni
fauts	flauts
fáv	fá
favi	fagi
fávi	fái
fávið	fáið
fávísku	fávisku
faxaðann	faxaðan
faxalar	faxaðar
faxara	faxar
faxis	faxi
faxu	fax
fbi	fái
fbúa	búa
fðikja	frikja
fdögg	dögg
fðtboltinn	fótboltinn
fðttin	vöttin
fe	fé
fè	fé
féa	fés;fé
féæ	fé
feæix	felix
feala	fela
féb	fé
február	febrúar
fèð	féð
feðg	feðga
feðgi	fegðin
feðgim	feðgum
feðgir	feðgar
feðgun	feðgum
feðgur	feður
feðgurð	fegurð
feðist	ferðist
feðjur	feður
féðjur	ferjur
féðmt	fermt
feeð	ferð
feeðalög	ferðalög
feékk	fékk
feel	fel
feerð	ferð
feǵ	fer;fé
fegð	feigð
fegðurð	fegurð
fegðurðina	fegurðina
fegg	vegg
feginleikin	feginleikinn
fegn	regn
fegr	fer
fegrð	ferð;fegurð
fegriðin	vegriðin
fegurast	fegurst
fegurasti	fegursti
fegurastur	fegurstur
fegurði	fegurðin;fegurð
fegurro	fegurri
fegust	fengust;fegurst
fehagnaður	fagnaður;hagnaður
feidías	Eidís
feiðsamur	friðsamur
feigann	feigan
feigði	eigðu
feigðu	eigðu
feiginleika	eiginleika
feiknann	feiknar
feiks	feykis
feiktur	feitur;feyktur
feilist	felist
feilla	fella;feila
feillar	feilar
feillast	heillast
feimini	feiminni
feimn	feimin
feimnis	feimni
feimnur	feimnir
feimuðs	feimaðs
fein	ein
feingið	fengið
feingu	fengu
feiningar	einingar
feinn	einn
feirð	ferð
feirir	feitir
feis	feigs
feisinu	fisinu
feiskur	fiskur
feisurnar	veisurnar;kveisurnar
feitans	feitan
feitr	feitur
feituð	feitur;fituð
feix	felix
feka	fleka;freka
feki	feyki;fleki;freki
féki	fékk
fekk	fékk
fekkk	flekk
fékkr	fékk
fekkst	fékkst
fekku	flekku;fengu
fékkur	fékk
feknum	freknum;fegnum
fékstu	fékkstu
fél	féll
felaa	fela
felag	félag
félagaformi	félagsformi
félagarnur	félagarnir
felagi	félagi
felaginu	félaginu
felaginy	félaginu
félagkapur	félagsskapur
félagsamþykktir	félagssamþykktir
félagsfræđibraut	félagsfræðibraut
félagsgerðra	félagsgerða
félagsin	félagsins
félagskap	félagsskap
félagskapr	félagsskapur
félagskapur	félagsskapur
felagskapurinn	félagsskapurinn
félagslyndin	félagslyndi
félagslyndinn	félagslyndið
félagssbústaðir	félagsbústaðir
félagsskapin	félagsskapinn
félagsskápurinn	félagsskapurinn
félasmiðsstöð	félagsmiðstöð
feldaðu	eldaðu
feldan	felldan
feldsins	eldsins;feldarins
felex	Felix
felg	felga
felgja	felga
felgs	felga
felgslum	felgum
felguró	felgur
feliks	felix
félindi	vélindi
feliri	fleiri
felirri	fleiri
felíx	felix
feliz	feli
feljast	teljast
felkominn	velkominn
fellaa	fella
fellaq	fella
fellar	fella
fellast	felast
fellbylur	fellibylur
felleg	falleg
fellegir	fallegir
fellibhlur	fellibylur
fellibilir	fellibyljir
fellibylatíma	fellibyljatíma
fellibylatímabil	fellibyljatímabil
fellibylatímabilið	fellibyljatímabilið
fellibyljat	fellibylja
fellina	vellina
fellipseyjum	filippseyjum
fellista	fallista
felljast	felldast;felast;dveljast
fellsmala	fellsmúla
fellybylur	fellibylur
féló	fló
félör	félög
fels	felst
felstir	flestir
felt	fellt
feltrun	felmtruð
feltta	fletta
fem	sem
femaði	hemaði
femðt	fermt
femenísk	femínísk
femi	feni
femið	feimið
femiða	farmiða;miða;fenið
femíniami	femínismi
femínis	femínsk;femínisti;femínísk
femínís	femínísk
feminisk	feimins;femínísk
femínisk	feminísk
femíniskt	femínskt;femínískt
feminisma	femínisma
feminismál	feimnismál
feminismi	femínismi
feminísmi	femínismi
femínist	femínisti;femínískt
feminista	femínista
feministi	femínisti
feminsta	femínista;féminnsta
féminsta	féminnsta;femínista
femm	fimm
femma	fema
femme	fema
femmu	femu
femnismál	feimnismál
femur	kemur;lemur
fémur	fimur
fén	féð
fena	fenna
fend	fernd
fenð	ferð
fendá	enda
fendi	endi
fengðu	fengu
fengiđ	fengið
fengiði	fengið
fenginnn	fenginn
fengji	fengi
fenneæ	fennel;fenni;fennir
fenngið	fengið
fenr	fer;fen
fensu	flensu
fenti	fengi
fentið	fengið
feöir	felir;ferðir;feður
fép	fé
fépa	fipa
fepð	ferð
fér	fer
ferd	ferð
ferđ	ferð
ferda	ferða
ferðaæag	ferðalag
ferðaði	ferðaðist
ferðafærður	ferðafærð
ferðafelag	ferðafélag
ferðaheildsalir	ferðaheildsali
ferðala	ferðalag
ferdalag	ferðalag
ferðalag.	ferðalag
ferðalangra	ferðalanga
ferdalast	ferðalest
ferdalg	ferðalag
ferðalg	ferðalag
ferðalognum	ferðalöngum;ferðalögum
ferðalögnum	ferðalögum;ferðalöngum
ferðamadur	ferðamaður
ferðamadurinn	ferðamaðurinn
ferđamálafeæđi	ferðamálafræði
ferðaman	ferðamann
ferđamannastađina	ferðamannastaðina
ferðamannirnir	ferðamennirnir
ferðamapur	ferðamaður
ferðamen	ferðamenn
ferðamennunum	ferðamönnunum
ferðasatka	ferðasaga
ferðaskifstofa	ferðaskrifstofa
ferðaskjalin	ferðasjalinu;ferðaskjölin
ferðaskrifastofa	ferðaskrifstofa
ferðaskrifsstofa	ferðaskrifstofa
ferđaskristofa	ferðaskrifstofa
ferðaslög	ferðalög
ferdast	ferðast
ferðataks	ferðatasks;fyrirtaks
ferðatöska	ferðatösku;ferðataska
ferðatöskunu	ferðatöskunum
ferðaþjón­ust­an	ferðaþjónustan
ferdða	ferða
ferðdast	ferðast
ferðdat	ferðast
ferðelag	ferðalag
ferðga	ferða;feðga
ferði	verði;ferðin
ferðið	ferðir
ferðinar	ferðirnar
ferðinna	ferðina
ferðinq	ferðin;ferðina
ferðis	ferðist;ferðir
ferdkan	ferskan
ferdli	ferli
ferðnar	ferðar
ferðöm	ferðum
ferdskan	ferskan
ferðslag	ferðalag
ferðú	ferðu
fereistaður	freistaður
ferflötungur	fergt;fergða
fergta	fergt;fergða
ferh	fer
ferhirnt	ferhyrnd;ferhyrnt
ferhryngur	feræringur;ferhyrningur
ferhyndur	ferhyrndur
ferhyr	freyr;ferhyrnd
ferhyringur	ferhyrningur
ferhyrn	ferhyrnd
ferhyrnntur	ferhyrningur;ferhyrndur
ferhyrntra	ferhyrndra
feria	ferja
feríki	ferlíki
ferilin	ferilinn
feríll	ferill
ferilsk	ferils;ferilskrá
ferilsk´ra	ferilskrá
feril­skrá	ferilskrá
férilskrá	ferilskrá
ferilskrán	ferilskráin
ferilsskrá	ferilskrá
ferir	fenrir
ferislkrá	ferilskrá
ferkanataður	ferkantaður
ferkðum	ferðum
ferksa	ferska
ferl	fer;ferli
ferldur	feldur
ferlir	ferli
ferliskrá	ferilskrá
fermð	fermd
ferme	ferma
fermingadagur	fermingardagur
ferm­ing­ar­	fermingar
fernað	ferna
fernhryngur	ferningur
fernhyngur	ferningur
fernn	fern
fernni	fenni
fernnri	fernri
fernnt	fernt
fernnur	fernur
fernts	fernt
ferö	fer
ferő	fer
feróla	ferla
ferp	fer;ferð
ferpferð	verferð;ferð
ferr	fer
ferrilskrá	ferilskrá
ferrna	ferna
ferrni	ferni
fersetning	forsetning
fersjkur	ferskur;ferskjur
ferskut	ferskt;ferskur
ferskyjur	ferskjur
fertalag	ferðalag
fertli	ferli
fertlið	ferlið
fertna	ferna
fertugasi	fertugasti
ferü	fer
fésað	fésið
feseif	fasreif
feskur	ferskur
fesri	festi
fessi	festi
festað	frestað
festafestu	festa;festu
festingur	festingar
festning	festing
festst	festist
festun	festu;festunni
festunnu	festunni
fesy	fest
fét	fet
fétan	fitan
fetani	fetaði;fentanýl
fetanil	fetarnir;fentanýl
fetðatékki	ferðatékki
fetist	festist
fetjið	fitjið;letjið
fetlaða	fatlaða
fetleitraður	feitletraður
fetleitruð	feitletruð
fetleitruðu	feitletruðu
fettaði	fetaði
fetu	feti
fetur	fet
fetus	fets
fevana	févana
fextaðra	fextara;textaðra
fexum	flexum
feygill	flygill
feygur	feigur
féyi	feyi
feyilegur	feykilegur;feikilegur
feykk	fékk
feyngu	fengu
feynni	eynni;fenni
féþ	fé
ffá	fá
ffag	fag
ffamundan	framundan
ffgh	fh
ffinna	finna;Finna
ffiskur	fiskur
ffjáls	frjáls
fflækja	flækja
fflf	fiff
fflytja	flytja
ffytja	flytja
fgengur	gengur
fgeta	geta
fialði	falið
fiárhúsunum	fjárhúsunum
fíbll	fíll;fífl
fíbra	víbra
fið	við
fiðaðan	fiðraðan
fiðdni	fildni
fiði	riði;liði
fidías	Fides
fidjieyjar	Fídjieyjar;Fídjíeyjar
fidjíeyska	fídjeyska
fiðkuleikari	fiðluleikari
fidkur	fiskur
fidla	fiðla
fiðnaða	fiðraða
fídnin	fíknin
fiðnu	riðnu;liðnu
fiðr	fiðri;fiður
fiðsaðan	fiðraðan
fíðusum	víðustum
fifa	fífa;rifa
fífaðu	fífaður
fifjuð	rifjuð
fíflanar	fíflana
fíflari	fíflar
fîflast	fíflast
fífldirfsk	fífldirfsku
fífldirfskur	fífldirfsku
fífldyrfskur	fífldirfsku
fíflingur	fílingur
figur	fígúra
figura	fígúra
fígura	fígúra
figurbjörgin	fingurbjörgin
figurna	fingurna
fiim	fimm
fiimm	fimm
fiina	fina;finna
fiinna	finna
fiinst	finnst
fíkiefni	fíkniefni
fikjum	fíkjum
fíkni¬efnaneyslu	fíkniefnaneyslu
fiksur	fiskur
fil	fíl
filadelfía	Fíladelfía
filadelphia	Fíladelfía
fílagu	fílaðu
filanum	filunum;fílnum
fílapensíll	fílapensill
filða	fila;fiðla
fileiki	fimleiki
fílelfdur	fílefldur
files	fles
filesd	flest
fileypskur	filippseyskur
filgd	fylgd
filgda	fylgda
filgdar	fylgdar
filgir	fylgir
filgyst	fylgist
filieyskur	filippseyskur
fílip	Filip
filipanskur	filippseyskur
filipeyskar	filippseyskar
filipeysku	filippseysku
filipeyskur	filippseyskur
filipínskur	filippseyskur
filipískur	filippseyskur
filipp	Filip;Filippus
filippeysk	filippseysk
filippeyskt	filippseyskt
filippeyskur	filippseyskur
filippíi	Filippíu
filippin	flippinu
filippíni	Filippíu
filippinseyjum	Filippseyjum
filippinska	filippseyska
filippínska	filippseyska
filippinskan	filippseyskan
filippinskum	filippseyskum
filippipseyjum	filippseyjum
filippiska	filippseyska
filippískur	filippseyskur
filippius	Filippus
fílippseyjum	filippseyjum
filippseyk	filippseysk
filippseyka	filippseyja
filippseyksa	filippseyska
filippseykur	filippseyskur
filippseyngar	Filippseyingar
filippseyu	Filippseyjum
filipsey	Filippseyjar
filipseyjingar	Filippseyingar
filipseyngur	Filippseyingur
filipska	Filips
filipus	Filippus
filjast	fyljast
fílkar	fílar
fill	fíll;vill
fillepseyski	filippseyski
fílling	fíling;fylling
fíllip	Filip
fillipeyskur	filippseyskur
fillippeyskur	filippseyskur
fillippseyjum	filippseyjum
fillippseyskur	filippseyskur
fillipseyar	Filippseyjar
fillipseyingar	Filippseyingar
fillipseyingur	Filippseyingur
fillipseyjar	Filippseyjar
fílll	fíll
filmand	filman
films	filma
fílmur	filmur
filningur	vinningur
filsnu	fildnu;fylgsni
filsnuð	visnuð
filtanna	piltanna
filtar	piltar
filterað	fallerað
filtg	filt
fílupúki	fýlupúki
fimarinn	eimarinn
fimbul	fimur
fimgur	fingur
fimgurra	fingurna
fimis	fimi
fimleikat	fimleika;fimleikar
fimmaur	fimmur
fimmmeningar	fimmmenningar
fimmmti	fimmti
fimmtadagur	fimmtudagur
fimmtan	fimmtán
fimmtàn	fimmtán
fimmtánti	fimmtándi
fimmtáun	fimmtán
fimmtudagin	fimmtudaginn
fimmtudagur$	fimmtudagur
fimmtudogum	fimmtudögum
fimmtudugum	fimmtudögum
fimmtudúgum	fimmtudögum
fimmtugödum	fimmtugföldum;fimmtudögum
fimmvörðuháls.	fimmvörðuháls
fimo	fimi
fimrinum	fingrinum
fimti	fimmti
fimtudaginn	fimmtudaginn
fimtudagur	fimmtudagur
fimtudagyr	fimmtudagur
fimtugadur	fimmtudagur
fimurinn	limurinn
fin	fín;finn
fín·pússa	fínpússa
fín]	fín
finale	vinaleg
fínann	fínan
finanndi	finnandi
finar	fínar
finarnar	firnarnar
finbogason	Finnbogason
finddinn	fyndinn
finden	fyndin
findið	fyndið
finðið	finnið;fyndið
finding	vinding
findinn	fyndinn
findist	fundist;fyndist
findland	Finnland
fíndland	Vindland;Indland;Finnland
findnar	fyndnar
findni	fyndni
findur	fundur
fine	fina
finest	finnst
finfinn	finn
finfónía	sinfónía
fingafar	fingrafar
fingar	fingur
fingarfar	fingrafar
finge	fingur
fingerða	fíngerða
fingerður	fíngerður
fingja	fingra;dyngja
fingr	fingur
fingrari	fingri;fingrafari
fings	fingurs
fingu	fingur;fengu
fingurra	fingurna
finhönd	yfirhönd
fini	finni;Finni
finland	Finnland
finlands	Finnlands
finlannd	Finnland
finmst	finnst
finnafinnst	finna;Finna;finnst
finnalnd	Finnland
finnar	Finnar
finnarnar	Finnarnir;kinnarnar
finnas	finnast
finnask	finnast
finnasta	finnast;fínasta
finnbogasson	Finnbogason
finnbógasson	Finnbogason
fínnbogasson	Finnbogason
finnd	fyrnd;finn
finnfint	Finninn;fínt;fínn
finngáln	finngálkn
fínngjöf	inngjöf
finnif	finni;Finni
finningur	vinningur;finni;Finni
finnlan	Finnland
finnlendka	innlenda;finnska
finnlns	Finnans;Finnlands
finnnist	finnist
finns	finna;Finna;finnst
fínnst	finnst;fínast
finnsta	finnst;fínasta
fínnur	finnur;Finnur
finsdist	fyndist
finska	finnska
finskur	finnskur
finst	finnst
fint	fínt
fintast	finnast
fintfinn	finninn;Finninn
fintið	finnið;fyndið
fintt	finn;fínt
fínur	fínir;fínn;línur
fiol	fitl
fiölði	fölri;fjöldi
fiölkunnigr	fjölkunnugur
fiölkunnigur	fjölkunnugur
fion	finn
fíon	fín
fíona	fína
fiörð	fjörð
fiörður	fjörður
fiórir	fjórir
fipaður	fipraður;flipaður
fipandi	fiplandi;flipandi
fípra	vípra
fipuð	flipuð
fipvast	fipast
fir	yfir;fit
firar	fitar
firðiir	firðir
firðildi	fiðrildi
firðindi	firnindi
firðist	virðist
firðstaða	birgðastaða
firðyndi	firnindi
fireldri	foreldri
firi	fiti
firkur	virkur
fírliði	fíliði
firmkanu	firmanu
firnafn	fornafn
firnastefkur	firnasterkur
firnbjörn	Finnbjörn
firnðindi	firnindi
firninum	firðinum
firragær	fyrradag
firramálið	fyrramálið
firrar	pirrar;firra;firrir
firskt	ferskt
first	fyrst
firsta	fyrsta
fiscur	fiskur
físilegt	fýsilegt
físís	físis
fisískt	fasískt
fisjur	fiskur
físk	fisk
fìsk	fisk
fiskai	fiski;fiska
fiskali	fisksali
fiskamaður	fiskimaður
fiskamenn	fiskimenn
fískar	fiskar
fiskbit	fiskbita
fiskbörum	fiskibörum
fiskbuðin	fiskbúðin
fiskfas	fiskfars
fiskiflak	fiskflak
fiskiflétta	fiskifrétta
fiskihaus	fiskhaus
fiskimatsmaður	fiskmatsmaður
fiskimi	fiskimið
fiskisloð	fiskislóð
fiskja	fiska
fiskker	fiskiker
fiskkur	fiskur
fiskrett	fiskrétt
fiskshaus	fiskhaus
fisksúða	fisksnúða
fisku	fiskur
fiskue	fiskur
fiskugur	fiskvegur
fiskujr	fiskur
fiskúr	fiskur
fiskurbátar	fiskibátar
físsni	físandi
fistaðu	vistaðu
fistu	fyrstu
fisuð	fisið
físumum	físunum
fítaðu	fitaðu
fitana	fituna
fitann	fitan
fitanna	fitan
fitans	fitan
fitanu	fitan
fitbolti	fótbolti
fitlaðan	fatlaðan;fitlað
fitlari	fitlar
fitlis	fitli
fitlu	fitlum
fitlun	fitlum
fitlur	filur
fitnaður	fatnaður;fitnaði
fítnin	fíknin
fits	fit
fittan	fitan
fittini	fitinni
fittinn	hittinn
fittinni	fitinni
fittinnu	fitinni
fittinu	filtinu
fittirðu	fettirðu
fittuð	fituð
fittun	fitun
fítuga	fituga
fítukertill	fitukirtill
fitusprengja	fitusprengt
fiuga	fluga
fixu	fixi
fixur	fixuð
fj-ðrin	fjöðrin
fj-ödi	fjöldi
fj<lskyda	fjölskylda
fj0gurra	fjögurra
fj0lskylda	fjölskylda
fja´r	fjör
fjaálfar	fjalar
fjaðrarrinnar	fjaðrarinnar
fjæri	færi
fjærlægja	fjarlægja
fjærlaga	fjárlaga
fjærri	færri
fjærstaddur	fjarstaddur
fjæru	færu
fjakk	flakk
fjalaða	fjallaða
fjalaðir	fjallaðir
fjalae	fjalar
fjalara	fjalar
fjalarnir	fjalirnar
fjaldi	fjöldi
fjallaðarr	fjallaðar
fjalladyrð	fjalladýrð
fjallagöngr	fjallgöngur
fjallagöngum	fjallgöngum
fjallagöngur	fjallgöngur
fjalla­leiðsögumaður,	fjallaleiðsögumaður
fjallalljón	fjallaljón
fjallara	fjallar
fjallaskíðun	fjallasíðuna
fjallaskin	fjallaskinn
fjallfn	fjallfé
fjallgángur	fjallgöngur
fjallgöng	fjallgöngu
fjallgonga	fjallganga
fjallgöngi	fjallgöngu
fjallgongu	fjallgöngu
fjallgöngu	fjallgöngu
fjállgöngu	fjallgöngu
fjallgrafinn¨	fjallgrafinn
fjallhringur	fjallahringur
fjálli	fjalli
fjallid	fjallið
fjalliđ	fjallið
fjallót	fjallátt
fjallrjupa	fjallrjúpa
fjallsal	fjallasal
fjallslétt	fjalslétt
fjallstindina	fjallstindana
fjalmiðli	fjölmiðli
fjälmörg	fjölmörg
fjálnið	úfjárnið
fjálsu	frjálsu
fjálsus	frjálsust
fjandands	fjandans
fjándskapur	fjandskapur
fjandunum	fjandanum
fjáoflun	fjáröflun
fjarægð	fjarlægð
fjarægda	fjarlægða
fjarægja	fjarlægja
fjarægt	fjarlægt
fjáraflanir	fjáraflanum
fjarann	fjaran
fjaraw	fjara
fjarðarborns	fjarðarbotns
fjárdhusinu	fjárhúsinu
fjárdhúsinu	fjárhúsinu
fjárfestari	fjárfestar
fjarfesting	fjárfesting
fjárfestingahreyfingar	fjárfestingarhreyfingar
fjárfestingaleiðir	fjárfestingarleiðir
fjárfestingaráðgjöf	fjárfestingarráðgjöf
fjárfestingavettvangur	fjárfestingarvettvangur
fjárfestingaþörf	fjárfestingarþörf
fjarhirslur	fjárhirslur
fjárhundr	fjárhundur
fjárhus	fjárhús
fjarkægð	fjarlægð
fjárlægð	fjarlægð
fjarlæǵður	fjarlægður
fjárlægður	fjarlægður
fjarlæggja	fjarlægja
fjarlægjun	fjarlægjum
fjárlægt	fjarlægt
fjarlaga	fjárlaga
fjarlagat	fjarlægast
fjarlegt	fjarlægt
fjarlegur	fjörlegur
fjarlǵður	fjarlægður
fjarmagna	fjármagna
fjármálasjóri	fjármálastjóri
fjármálatofnun	fjármálastofnun
fjármögun	fjármögnun
fjármun	fjármuni
fjarnemi	fjarnámi
fjároflun	fjáröflun
fjáröflun	fjáröflun
fjáröfluninni	fjáröfluninni
fjáröflunni	fjáröfluninni
fjarr	fjarri
fjarsælt	farsælt
fjarsamband	fjársamband
fjárslóðann	fjárslóðanna
fjarst	fjærst
fjartengst	fjartengt
fjarugur	fjörugur
fjarvesta	fjarvista
fjárvesta	fjárfesta
fjarvestin	fjarvistin
fjárvist	fjarvist
fjarvistur	fjarvistir
fjasin	fjósin
fjátistu	játastu
fjauka	frauka
fjáum	fáum
fjélagar	félagar
fjéll	féll
fjeril	feril
fjerna	ferna
fjeyka	freyja;Freyja;feykja
fjfif	fiff
fjjóta	fljóta
fjlall	fjall
fjljótur	fljótur
fjljúga	fljúga
fjlömiðla	fjölmiðla
fjlót	fljót
fjlskylda	fjölskylda
fjluga	fluga
fjlúga	fljúga
fjoð	fjáð
fjóði	fjórði
fjoðir	fjáðir
fjödir	fjöður
fjóðji	fjórði
fjöðr	fjör
fjödrin	fjöðrin
fjóðskylda	fjölskylda
fjóduft	frjóduft
fjöðurinn	fjörðurinn
fjöðurö	fjöður
fjögrra	fjögurra
fjogur	fjögur
fjógur	fjögur
fjógúr	jógúrt
fjögúr	fjögur
fjögut	fjögur
fjögutr	fjögur
fjöguu	fjögur
fjókorna	frjókorna
fjöksylda	fjölskylda
fjöla	fjölda
fjölagur	fjölhagur
fjólblá	fjólublá
fjólblár	fjólublár
fjölbreitileiki	fjölbreytileiki
fjölbretni	fjölbreytni
fjölbrettur	fjölbreyttur
fjôlbreyt	fjölbreytt
fjölbreytast	fjölbreyttast
fjôlbreyti	fjölbreytni
fjölbreytinglega	fjölbreytilega
fjôlbreytnin	fjölbreytnin
fjôlbreytninn	fjölbreytninni
fjolbreytt	fjölbreytt
fjölbreytting	fjölbreytti
fjölbreytum	fjölbreyttum
fjölbryta	fjölbreytta
fjölbrytum	fjölbreyttum
fjöldan	fjöldann
fjoldi	fjöldi
fjölði	fjöldi
fjoldkylda	fjölskylda
fjöldkyldu	fjölskyldu
fjöldni	fjöldi
fjöldskilda	fjölskylda
fjöldskylda	fjölskylda
fjōldskylda	fjölskylda
fjöldur	fjöldi
fjólgað	fjölgað
fjolgast	fjálgast
fjólgast	fjálgast
fjölgisk	fjölgi
fjolgist	fjölgisti
fjölgyðs	fjölgyðis
fjölgyðstrú	fjölgyðistrú
fjólk	fólk
fjölkirni	fjölinni
fjölklda	fjölda
fjölksilda	fjölskylda
fjolkskylda	fjölskylda
fjölkskýlda	fjölskylda
fjölkskyldu	fjölskyldu
fjolksylda	fjölskylda
fjölkunnig	fjölkunnug
fjölkunnigur	fjölkunnugur
fjölkunnugr	fjölkunnugur
fjölkyðum	fjölliðum
fjölkylda	fjölskylda
fjölkylðum	fjölyrðum
fjölkynni	fjölkynngi
fjöllagur	fjölhagur
fjöllbreytur	fjölbreyttur
fjöllganga	fjallganga
fjölliðari	fjölliðaðri
fjöllítur	fjöllitur
fjöllkynni	fjölkynngi
fjöllmenntur	fjölmenntar
fjöllskýlda	fjölskylda
fjöllunn	fjöllin
fjöllur	fjöllum
fjólmenni	fjölmenni
fjölmidla	fjölmiðla
fjölmiðlarafræði	fjölmiðlafræði
fjölmiðlir	fjölmiðlar
fjölmiðlu	fjölmiðlum
fjölmörgun	fjölmörgum
fjölog	félög;fjöll;fjölum
fjolskilda	fjölskylda
fjólskilda	fjölskylda
fjölskilda	fjölskylda
fjölskildan	fjölskyldan
fjölskildar	fjölskyldur
fjölskildina	fjölskylduna
fjölskildu	fjölskyldu
fjölskildunar	fjölskyldunnar
fjölskildur	fjölskyldur
fjölskjld	fjölskjals
fjölskjldu	fjölskyldu
fjölsklyda	fjölskylda
fjölsklydu	fjölskyldu
fjölsklydur	fjölskyldur
fjölskrúðugr	fjölskrúðugar
fjölsku	fölsku
fjölskulda	fjölskylda
fjölskuldu	fjölskyldu
fjölskyda	fjölskylda
fjölskydan	fjölskyldan
fjölskydu	fjölskyldu
fjölskyðu	fjölskyldu
fjölskyla	fjölskylda
fjölskyld	fjölskyldu;fjölskylda
fjolskylda	fjölskylda
fjólskylda	fjölskylda
fjölskylða	fjölskylda
fjölskýlda	fjölskylda
fjölskylðan	fjölskyldan
fjölskýldan	fjölskyldan
fjölskýldar	fjölskyldur
fjölskylðdur	fjölskyldur
fjölskyldi	fjölskyldu
fjölskyldina	fjölskylduna
fjölskýldu	fjölskyldu
fjōlskyldu	fjölskyldu
fjólskylduna	fjölskylduna
fjölskyldunar	fjölskyldunnar
fjölskyldunn	fjölskyldunni
fjolskyldunni	fjölskyldunni
fjolskyldur	fjölskyldur
fjölskýldur	fjölskyldur
fjölskyldy	fjölskyldu
fjölskyldyr	fjölskyldur
fjölskyli	fjölskyldu
fjölskylsda	fjölskylda
fjölskylyda	fjölskylda
fjölskyndu	fjölskyldu
fjölsyldu	fjölskyldu
fjölsylduleiðing	fjölskylduleiðin
fjólu·blár	fjólublár
fjólubá	fjólublá
fjólubár	fjólublár
fjólubláe	fjólubláa
fjólublâr	fjólublár
fjólublát	fjólublátt
fjölunni	fjörunni
fjölvíðs	fjölvís
fjölyrður	fjölyrðir
fjolyskylda	fjölskylda
fjölyskylda	fjölskylda
fjölþáttur	fjölþættur
fjömiðlum	fjölmiðlum
fjön	fjör
fjoö	fjör
fjór	fjör;bjór;fjós
fjorar	fjórar
fjórár	fjórar
fjorð	fjörð
fjórð	fjórði;fjörð
fjörd	fjörð
fjorða	fjórða
fjórda	fjórða
fjorði	fjórði
fjördi	fjöldi
fjorðin	fjörðinn
fjördin	fjöldin
fjördir	fjörnir;firðir
fjórðja	fjórða
fjórðji	fjórði
fjördrin	fjörðurinn
fjörðrin	fjöðrin
fjörðrinni	fjöðrinni
fjörðungur	fjórðungur
fjordur	fjörður
fjorður	fjörður
fjördur	fjörður
fjörðut	fjörðum
fjorgur	fjörugur
fjörgynja	fjörgynjar
fjórí	fjóra
fjörinni	fjörunni
fjorir	fjórir
fjorír	fjórir
fjörir	fjórir
fjörjugga	fjöruga
fjorór	fjöróð
fjórra	fjóra
fjórrar	fjórar
fjórtæan	fjórtán
fjörtánda	fjórtánda
fjórtánði	fjórtándi
fjörtándi	fjórtándi
fjörtður	fjörður
fjórtíu	fjörutíu
fjörtíu	fjörutíu
fjörugga	fjöruga
fjóruir	fjórir
fjöruni	fjörunni
fjörûr	fjörur
fjorvanir	forvarnir
fjoryr	fjórir
fjósakletti,	fjósakletti
fjösklydu	fjölskyldu
fjöskulda	fjölskylda
fjöskuldu	fjölskyldu
fjóskyld	fjærskyld
fjóskylda	fjölskylda
fjöskylda	fjölskylda
fjöskylða	fjölskylda
fjöskyldar	fjölskyldur
fjöskyldi	fjölskyldu
fjöskyldur	fjölskyldur
fjöskynda	fjölskylda
fjöslkulda	fjölskylda
fjöslkyldumeðlimur	fjölskyldumeðlimur
fjöslskylda	fjölskylda
fjösnar	þjösnar
fjöt	föt
fjótándu	fjórtándu
fjötla	fjötra
fjötlu	pjötlu
fjóttur	þjóttur
fjötutíu	fjörutíu
fjóum	fjórum
fjóurir	fjórir
fjóvga	frjóvga
fjqll	fjöll
fjrjór	frjór
fjúga	fljúga
fjúrar	fjórar
fjúrir	fjórir
fkara	fara
fkjúga	fljúga
fkölsklda	fjölskylda
fkölskylda	fjölskylda
fköttur	köttur
fkyrr	fyrr
fl9kin	flókin
fláanni	fláann
fláðins	flæðins
flæd	flæmd
flædar	flæðar
flægtar	flæktar
flæik	flæk;læk;lauk;flaug
flækna	lækna
flæknar	læknar
flænsta	flæsta
flæra	fleira
flæru	fleiru
flæsk	flæmsk
flæstna	flæsta
flæstrið	flæstri
flæt	flætt
flæytt	flætt
fláglega	láglega
flagrið	flagið
fláinna	fláinn
flajj	flakk
flakaka	flakka
flakake	flakka
flákn	fláka
flámældur	flámæltur
flanda	landa
flandern	flandra
flángs	flangs
flangslega	flónslega
flánina	flánna
flansta	flansa
flánsta	fláasta
flapaðan	flipaðan
flasaka	flaska
flaskur	flöskur
flásna	flásuna
flastið	plastið
flastna	flana
flástna	flásuna
flastrið	flaustrið
flástrið	plástrið
flataðan	flautaðan
flatanað	flatana
flatkak	flatkaka
flatkaku	flatköku
flatkoku	flatköku
flatnað	fatnað
flatská	flatskjá
flattnef	flatnef
flattnefs	flatnefs
flauðust	flaust
flaugur	flugur
flaugust	flugust
flaukust	flugust
flaumir	flaumur
flaumslítum	flaumslitum
flaumst	flaust
flaumust	flaumur
flauttuna	flautuna
flauttunna	flautuna
flautuleikar	flautuleikari
flauturskenndur	flausturskenndur
fleðnu	freðnu
flegjya	fleygja
flegnu,	flegnu
fleigun	fleygun
fleingi	flengi
fleingir	flengir
fleinis	fleins
fleir	fleiri
fleiritala	fleirtala
fleirtöuna	fleirtöluna
fleiru	fleiri
fleirum	fleiri
fleitala	fleirtala
fleitnu	fletinu
fleitti	fleytti
fleitun	leitun
flekaðstu	flekaðistu
flékk	fékk
flekkap	flekka
flékkót	flekkótt
flékkótt	flekkótt
fleming	flemming
flemingur	flæmingur
flems	fles
flengji	flengi
flennsa	flensa
flensta	flesta
flénsta	flesta
fleri	fleiri
fleritala	fleirtala
flesitr	flestir
flessaða	blessaða
flestna	flesta
fléstna	fléttna
flestrið	flestri
fletaða	fletta
fletaðan	flettan
fletar	flestar
fletínum	fletinum
fletjara	fletja
fletjha	fletja
flettaðu	fléttaðu
fletu	flestu
fleura	fleira
fleva	fleka
fleygður	fleygur
fleyght	fleygt
fleyguður	fleygur
fleykja	fleygja
fleyra	fleira
fleyri	fleiri
fleyrir	fleytir
fleyttii	fleytti
fleyur	fleygur
flicka	flika
flickan	flikan
fliðla	friðla
flíðla	friðla
fliei	flipi
flig	flug
fliggja	liggja
fligja	fleygja
fligrað	flingrað
fligsi	flugsi
flik	flík
flíkari	líkari
flíkast	líkast
flíkastu	flikastu
flikkjast	flykkjast
flikkótt	flekkótt
flíkuberg	flikruberg
flíkust	líkust
flimma	fimma
flimrir	flimtrir
flimsann	flimskan
flimsið	flimið
flimur	filmur
flíngkur	flinkur
flíngur	flingur
flinnsborg	Finnborg
flínsborg	Flensborg
flinsta	flinta
flínsta	fínasta
flip	flipp
flippseyjing	Filippseying
flippseyjingur	Filippseyingur
flirt	flimt
flisalagt	flísalagt
flisinu	flissinu
flísinu	flísina
flisnu	flissinu
flíssa	flísa
flistna	flimtna
flístna	flísina
flistrið	flimtrið
flístrið	blístrið
flitja	flytja
fliúgandi	fljúgandi
flíya	flísa
flj-uga	fljúga
fljæót	fljót
fljæuga	fljúga
fljetta	flétta
fljiga	fljúga
fljíga	fljúga
fljólega	fljótlega
fljóllegur	fljótlegur
fljorar	fjórar
fljórar	fjórar
fljot	fljót
fljota	fljóta
fljötlega	fljótlega
fljótskrift	fljótaskrift
fljóttur	fljótur
fljøuga	fljúga
fljua	fljúga
fljúa	fljúga
fljuga	fljúga;fluga
fljúga,	fljúga
fljúgar	fljúga
fljúgaudi	fljúgandi
fljúgav	fljúga
fljúgja	fljúga
fljugvel	flugvél
fljúha	fljúga
fljúka	flúgja;fjúka
fljýa	flýja
fljýga	fljúga
fljyta	fljóta
fllott	flott
fllötur	flötur
fllýtja	flytja
flo	flot
floggum	flöggum
flóggum	flógum
flögru	fögru
flögskylda	lögskylda
flógyn	flogin
floí	flot
floka	flokka
flokinn	flokkinn;flókinn
flókka	flokka
flökka	flokka
flokkanir	flokkarnir
flókkið	flókið
flókkin	flókin
flokkkur	flokkur
flokkræði	flokksræði
flokkræðis	flokksræðis
flokkstarf	flokksstarf
flókkurt	flokkur
floknir	flóknir
flokun	flokkun
flokurt	flökurt
flölklda	fölkalda
flöll	fjöll
floni	flotti
flonsta	flottasta
flónsta	flónska
flönsta	flesta
flörður	fjörður
flöri	fjöri
flórsin	flórsins
flort	flott
flortana	flotana
flösa	flösu
flósir	flóir
flöskar	flöskur
flöski	flösku
flösko	flösku
flösnar	flosnar
flostna	flosna
flóstna	fóstra
flöstna	flösuna
flostrið	fóstrið
flóstrið	fóstrið
flöstrið	flögrið
flötan	flötin
floteina	fláteina
flotnara	flottara
flótt	fljótt;flótti;flott
flóttamaðu	flóttamaður
flötungar	flökunar
flotur	flottur
flovent	Flóvent
fltja	flytja
fluayga	fleyga
flúðari	flúðri
fluðast	fliðast
fluf-gvél	flugvél
flufji	flugi
flúg	flug
flúga	fluga;fljúga
flúgar	flugar
flugeldae	flugelda
flugevél	flugvél
flugévellir	flugvellir
flugfer	flugferð
flugferđ	flugferð
flugfragt	flugfrakt
flugfreya	flugfreyja
flugfreyjar	flugfreyja
flúgga	flagga
flugja	fluga;fljúga
flúgja	fljúga
fluglahræða	fuglahræða
flúglar	flyglar
flugnabu	flugnabú
flugnasveimar	flugnasveimur
flugnummerið	flugnamergð
flugprófun	flugprófum
flugrák	flugráð
flug­stjór­	flugstjóri
flug­stjór­ans	flugstjórans
flugtúru	flugtúr
fluguél	flugvél
flugurskreyttur	fagurskreyttur
flugválar	flugvélar
flugvel	flugvél
flúgvel	flugvél
flúgvél	flugvél
flugvelar	flugvélar
flugvélarlíian	flugvélarlíkan
flugveldur	flugeldur
flugveli	flugvelli
flúgveli	flugvelli
flúgvéli	flugvélin
flugvelinn	flugvélinni
flugvelinni	flugvélinni
flugvélinnn	flugvélinni
flúgvéll	flugvél
flugvellar	flugvallar
flugvéllar	flugvélar
flúgvéllin	flugvélin
flugvellinu	flugvellinum
flugvéllir	flugvellir
flúgvellir	flugvellir
flúgvellur	flugvöllur
flugvellurinn	flugvöllurinn
flugvelþ	flugvél
flugvjel	flugvél
flugvol	flugvél
flugvölinn	flugvöllinn
flugvöllin	flugvöllinn
flugvollum	flugvöllum
flugvvel	flugvél
flúgþjón	flugþjón
flúgþjónn	flugþjónn
fluha	fluga
flujga	fluga
flukri	flökri
flumast	flumrast
flundrið	flandrið
flundur	fundur
flunki	flinki
flunku	flinku
flunsta	filista
flúnsta	fúnasta
fluntaða	plantaða
flúrarar	flúraðar
flúrin	flúin
flúrl	flúr
flurti	flutti
flustna	fluskna
flústna	flúna
flustrið	flaustrið
flústrið	flúskrið
flut	flutt
flutaðan	flautaðan
flutingut	flutningu
flutje	flytja
flutni	flutti
flutnig	flutning
flutnigur	flutningur
flutting	flutning
fluttirt	fluttir
fluttningarbíll	flutningabíll
fluttningur	flutningur
flütur	flytur
fluvél	flugvél
flúvel	flúnel
fluvellar	flugvallar
fluvelli	flugvelli
fluvöll	flugvöll
fluvöllur	flugvöllur
flýaðist	flóaðist
flýar	flýr
flýðast	hlýðast
flýðist	lýðist
flyga	fluga
flýga	flýja;fljúga
flygði	fleygði
flýgga	flagga
flygja	flytja;flýja;fleygja
flýgja	flýja
flygte	fleygt
flygur	flýgur
flygvöllur	flugvöllur
flyja	flýja;flytja
flýjar	flýja
flyjja	flytja
flýjun	flýjum
flyk	flík
flýk	flík
flykjast	flykkjast
flýkkja	flykkja
flýkkun	flokkun
flýnast	frýnast
flynsta	fyrsta
flýnsta	flýta
flystna	lystina
flýstna	aflýstra
flystrið	flaustrið
flýstrið	lýstrið
flyta	flýta;flytja
flytá	flyt
flýtaðar	flýtkaðar
flýtana	flýtina
flýtanna	lýtanna;fljótanna
flytar	flytur
flýtist	flýtis
flytj	flytja
flýtja	flytja;flýta
flytjaa	flytja
flytjq	flytja
flytjs	flytja
flýtjum	flytjum
flytjz	flytja
flytka	flytja
flytra	flytja
flýtra	flýta
flýtt	flýtt
flytta	flýta
flyttjast	flytjast
flyttur	flytur
flýuga	fluga
flyugur	flugur
flýxtur	flýtur
fmaður	maður
fmarfir	farfir;þarfir;marðir;farðir
fmyg	feyg
fnaut	naut
fnd	fund
fndir	undir;fundir
fnera	frera
fni	efni
fnísa	físa
fnna	finna;Finna
fnrádregin	frádregin
fnus	fnas
fnýa	knýa
fnyx	ónyx
fö	föt
fö∂ur	föður
fóant	fant
foárn	forn
fob	fox
fóbia	fóta
foð	for;roð
fódbolti	fótbolti
fǿði	fæði
fóðir	fóður
fóðjur	fóður
föðlingur	öðlingur
föðmuðumdt	föðmuðumst
foðnu	roðnu
fǫður	föður
föðuri	föður
föðurlanf	föðurland
födurnum	föðurnum
föðurri	föðurarfi
fóelluvatn	fóelluvötn
foerir	forir;þorir
fögður	föður
fögnun	fögnum
fögnupur	fögnuður
fögt	föt
fogur	fögur
fögurð	fegurð
fögut	fögur
foingi	foringi
fók	fólk
fokheldið	fokheldir
fokheldis	fokheldi
fokhelld	fokheld
fóki	fólki
fókið	fólkið
fokiða	fokið
fokker	fokkar
fókkið	fólkið
foksandhólar	foksandshólar
fóksir	fókusar
fólald	folald
fölald	folald
foldald	folald
földi	fjöldi
foldiði	moldiði
földun	fölsun
földurinn	feldurinn
folerdrar	foreldrar
fólgast	fólgnast
folk	fólk
fôlk	fólk
fölk	fólk
fólkari	fólskari
folki	fólki
fólkin	fólki
fólkipð	fólkið
fólkit	fólki
fólklk	fólk
folks	fólks
folkskylda	fólkskylma
fólkskylða	fólkskylfa
fölksva	fölskva
follald	folald
folll	foli
follla	frolla
fólnarlamb	fórnarlamb
fólnuðu	fórnuðu
fólsið	fólkið
fólsir	fólskir
folskilda	tollskylda;fjölskylda
fölskjylda	fjölskylda
fólskulegr	fólskulegri
fölskun	fölskum
fölskyldunnar	fjölskyldunnar
fölskyldur	fjölskyldur
fölskylður	fölskaður
föminsta	féminnsta;femínista
fömur	föður
fon	von
fönðra	föndra
fondue	vondu
fönður	föður
föngast	fangast
fönuði	fögnuði
föolur	fölur
fõr	fór
før	fór
for¬sæt¬is¬ráðherr¬an¬um	forsætisráðherranum
forald	folald
fórár	frár
forárn	forn
fórbolti	fótbolti
forborne	forborna
ford	form
forðabakskaut	forðabakstur
fordast	forðast
forðats	forðast
forðis	forðist
fórdoma	fordóma
forðstofa	borðstofa
forðu	forðum
förðuns	förðun
förður	föður;fjörður
foredlri	foreldri
foreld	foreldra;foreldri
foreldara	foreldra
forelddrar	foreldrar
foreldlar	foreldrar
foreldrara	foreldrar
foreldrarr	foreldrar
foreldrasamstraf	foreldrasamstarf
foreldraskiemtun	foreldraskemmtun
foreldrii	foreldri
foreldrinar	foreldrar;foreldri
foreldrir	foreldrar;foreldri
foreldrl	foreldri
foreldrrar	foreldrar
foreldrsr	foreldrar
foreldta	foreldra
foreldum	foreldrum
foreldur	foreldrar;foreldri
forelfrum	foreldrum
forelodi	foreldri
foreni	forni
forest	forlest
foresta	forysta
forestur	frestur
forétt	forrétt
foréttur	forréttur
fórettur	forréttur
fóretur	forréttur
förfáa	örfáa
forfaður	forfaðir
forfærd	forfærð
forfærdre	forfærðra
forfeðir	forfeður
forgangsðóstur	forgangspóstur
fóri	fór;Dóri
foristumann	forystumann
foristumanna	forystumanna
forit	forrit
foritari	forritari
forkauprétt	forkaupsrétt
forkkun	flokkun;vorkunn
forkrafa	formkrafa
forkröfu	formkröfu
forkröfur	formkröfur
forku	orku
forkunarfagurri	forkunnarfagurri
forleldra	foreldra
forlelrdar	foreldrar
forlerdar	forlegrar;foreldrar
forlerdra	foreldra
forlova	forlofta
formaðujr	formaður
formal	formál;formáli
fórmáli	formáli
forman	formann
formdæma	fordæma
formdæmalausri	fordæmalausri
formendurnir	formælendurnir
formgerðarsinnar	formgerðarinnar
formhönnun	forhönnun
formiði,	formið;formiði
fórmlega	formlega
förmn	förin
formúga	formúla;formúa
formúl	formúla
formula	formúla
fórmulu	formúlu
fornagripur	forngripur
fórnalamb	fórnarlamb
fornaldur	fornaldar
fórnalömb	fórnarlömb
fórnarlambana	fórnarlambanna
fornðfn	fornöfn
fornegyptar	fornegypskar
fórnfýsni	fórnfýsi
förninga	ferninga
fornofn	fornöfn
fórnöfn	fornöfn
fornorræn	fornnorræn
fornorræna	fornnorræna
forntíða	forntíðar
forrétur	forréttur
forrysta	forysta
forsætisræaðherra	forsætisráðherra
forseri	forseti
forsetaframbjóðendi	forsetaframbjóðandi
fórseti	forseti
forsetin	forsetinn
forsetisembætti	forsetaembætti
forsetnign	forsetning
forsetningaliður	forsetningarliður
forsett	forseti
forsetti	forseti
fórsið	forsið;forsíða;offorsið
forsiðau	forsíða;forsíðu
forsjálnis	forsjálni
forsjárman	forsjármann
forskað	forskalað
forskoð	forskoða
första	fyrsta
forstióri	forstjóri
forstöðurmaður	forstöðumaður
forstova	forstofa
forstufo	forystufé
försvinna	fjölsvinna
förti	förli
fortid	fortíð
fortið	fortíð
fortiðarinar	fortíðarinnar
fortiðarinnar	fortíðarinnar
fortíðaþrá	fortíðarþrá
fortip	porti;fortíð
fortípina	fortíðina
fórtiu	fórstu
fortvini	fornvini;forvitni
fortvitni	forvitni
foru	fóru
fórue	fóru
fórumanna	frumanna
forumúlu	formúlu
forund	forundran
forvarnavika	forvarnarvika
forverða	forvera
forvítin	forvitin
forvítinn	forvitinn
forvorður	forvörður
foryngi	foringi
forystuhlutverl	forystuhlutverk
fos	foss
fosd	foss
fosfor	fosfór
fösi	föst
fösir	fýsir
foskur	flöskur;öskur;froskur
fösli	föli
fossaleynir	fossaleyni
fossaru	fossar
fossberi	fossbergi
fosshólli	fosshóli
fosst	foss
fossur	foss
fóssvogi	Fossvogi
fostadaginn	föstudaginn
fóstadaginn	festardaginn
föstadaginn	föstudaginn
fosti	fóstri
föstn	föst
föstna	föstuna
föstnar	fastnar
fóstraru	fóstrarðu
föstudaf	föstudag
föstudagyr	föstudagur
föstudgaur	föstudagur
fóstuforeldrar	fósturforeldrar
fóstuforeldri	fósturforeldri
föstun	föstum
fösturdagur	föstudagur
fósturnar	fóstrurnar
fot	fót;föt;oft
fótaða	fótað
fótafit	fótafimt
fótartak	fótatak
fotaskápur	fataskápur
fotaskemill	fótaskemill
fótasta	fóta
fótbal	fótbað
fótbola	fótbolta
fótbolit	fótbolti
fótboll	fótbolti
fótbolla	fótbolta
fótbolli	fótbolti
fotbolta	fótbolta
fótboltalip	fótboltalið
fótboltaþjálfunarskólum.	fótboltaþjálfunarskólum
fótbólti	fótbolti
fòtbolti	fótbolti
fótbóltur	fótboltar
fótbotla	fótbolta
fótbotlta	fótbolta
fotek	fortek
fótelggja	fótleggja
fótfjölina	fótafjölina
fötgun	fötlun
fǿti	fæti
fótina	fótinn
fötinn	fötin
fötla	föla
fötlegg	fótlegg
fótleggin	fótlegginn
fótleggurin	fótleggurinn
fotlegur	lotlegur;fótleggur
fótlegurin	fótleggurinn
fótlegurinn	fótleggurinn
fötli	föli
fótmulu	fótsmugu
fótnum	fætinum
foto	föt
fótsnýrting	fótsnyrting
fótsýnrting	fótsnyrting
fötti	fött
föttin	fötin
föttina	fönina
fótue	fótum
fotur	fótur;fætur;votur
fotúr	fótur
fõtur	fætur
fótura	fótur
foturinn	fóturinn
fóturvetur	fósturvefur
fótut	fótum
foxað	afoxað;oxað
foxar	afoxar
foybolta	fótbolta
fprnafn	fornafn
fprvitinn	forvitinn
fqgur	fögur;fagur
fqsteign	fasteign
fr	fer;frí;frá
fr;i	fríi;frí
fr;nda	frænda
fr´nka	frænka
fr´skilt	fráskilið
fra	frá
frà	frá
fraændi	frændi
frábae	frábað;frábær
frábærann	frábæran
frábaert	frábært
fràbært	frábært
frábærtur	frábærastur
frábeær	frábær
frábeært	frábært
fráblr	frábær
frábrært	frábært
frábrigðni	frábrigði
frábrugð	frábrugðið
frábrugdið	frábrugðið
frábrugðimm	frábrugðinn
frábrut	frábært;frábrugðið
frábrygði	frábrigði
fræabær	frábær
fræabærir	frábærir
fræandi	frændi
fræani	fræni;frændi
fræbær	frábær
fræbært	frábært
fræbárt	frábært
fræber	frábær
fræbért	frábært
fræda	fræða
fræði7	fræði
frædinga	fræðinga
fræðingrein	fræðigrein
fræðingreinar	fræðigreinar
fræðingreini	fræðigreinin
fræðinguir	fræðingur
frædingur	fræðingur
fræđingur	fræðingur
fræðingurin	fræðingurinn
fræðinigur	fræðingur
frædir	fræðir
fræðirann	fræðimann
fræðisvið	fræðasvið
fræðlinga	fræðinga;græðlinga
fræðoi	fræði
fræðslaus	fræðslu
fræðstu	fræðslu
frædu	fræði;fræðum
fræðu	fræði;fræðum
fræettir	fréttir
frægan]ll-	frægan
frægastu	frægastur
frægat	frægar;fræga
fræggur	frægur
frægjunum	fræjunum
fræglega	frægilega
frægtur	frægur
frægurra	frægur;frægra
fræhur	frægur
fræka	frækna
frækan	frækinn
frækir	frægir;fræknir
frænd	frændi
frænða	fræða;frænda
frændhygili	frændhygli
frændin	frændi;frændinn
frændir	frændi;frændur
frændsystki	frændsystkin
frændsystkynin	frændsystkinin
frængri	frægri
frænja	frænka
frænkar	frænka
frænkasystkini	frændsystkini
frænki	frændi;frænka
frænlka	frænka
frænsk	frönsk;franska
frænta	frænda
fræsinnu	fræsingu
fræstist	freistist
fræstuða	fræstuð
frættana	frænanna
fræu	fræjum;fræ
fræum	fræjum
fræun	fræjum;fræjunum
frájls	frjáls
frakk	frakka
frakkalandi	Frakklandi
frakkí	frakki;Frakki
frakkínn	frakkinn;Frakkinn
frakkki	frakki
frakklan	Frakkland
frakland	Frakkland
fraknaðri	flaknaðri
frál	frá
frálegg	fráleg
fráleggur	frálegur
fráleiddur	fráleitur
fráls	frjáls
framanburður	framburður
framapotari	framapots
framarvonin	framavonin
framastu	fremstu
frambjoðandi	frambjóðandi
frambjóðando	frambjóðandi
framburðir	framburðar;framburður
framdregar	framdregnar
framdregnur	framdregnir
framfleigt	framleigt;framfleytt
framfleita	framfleyta
framfleitt	framfleytt
framfleygt	framfleytt
framfylging	framfylgi
framfylgni	framfylgi
framgegna	framgengna
framgegnt	framgengt
framhaldid	framhaldið
framhaldskóla	framhaldsskóla
framháldsskóli	framhaldsskóli
framhaldssóli	framhaldsskóli
framháls	framhalds
framhlut	framhluti
framhlutan	framhlutann
framhlutir	framhluti
framhöld	framhald
framina	framin
framindan	framundan
framistaða	frammistaða
framit	frami;framið
framja	fremja
framkæmda	framkvæmda
framkvæd	framkvæmd
framkvæmdarkostnaður	framkvæmdakostnaður
framkvæmtt	framkvæmt
framlá	framlág
framlaði	bramlaði
framlagnin	framlagning
framlágr	framlágir
framleða	framleiða
framlegða	framleiða;framlegð
framlegja	framlengja
framlegning	framlenging;framlagning
framlei	framleitt;framleiða
framleiðini	framleiðni
framleiðla	framleiðsla
framleisla	framleiðsla
framlekt	framlegt
framleytt	framleitt
framlin	framin
framljósinn	framljósin
frammendi	framendi
frammhald	framhald
frammistöður	frammistöðu
frammstaða	frammistaða
frammtennur	framtennur
frammyndan	framundan
framrúðinni	framrúðunni
frámrúðunni	framrúðunni
framsækja	framsækna
framsagna	framsagnar
framska	franska
frámsög	frásögn;framsögu
frámsöguer	frásögur;framsögu
framsögurháttur	framsöguháttur
framssöguháttur	framsöguháttur
framstæðni	framstæði
framtðar	framtíðar
framtid	framtíð
framtið	framtíð
framtíðarinar	framtíðarinnar
framtíðð	framtíð
framtiðina	framtíðina
framtiíð	framtíð
framtin	framin
framyndan	framundan
franak	frank;franska
fránis	fráni
frankaland	frakkland
frankaríki	framaríki
franklin	franklín
franks	franka;fransks
franksir	franskir
franksur	franskur
fransa	franska
fransfa	franska
fransgar	franskar
fransk	franska;franski;frönsk
fránsk	franska
franskat	franskar
fransku	franska;frönsku
frantir	frontir
frar	fram;frat
frá­rennsli	frárennsli
frasinu	þrasinu
fraska	franska
fráski	ráski
fráskillinn	fráskilinn
fráskilt	fráskila;fráskilið
fraskorið	framskotið
frasl	drasl
frásneyddari	frásneiddari
frásög	frásögn
frasögn	frásögn
frásögninna	frásögnina
frástyrkingar	frástyrkingar
frátæki	fátæki
fratig	frati
fratinni	fraktinni
fratni	frati
fratti	fatti;dratti
frattið	fattið
fraubert	Aubert;frábært
fraumi	draumi
fraumist	framist
fraunar	raunar
fraunir	raunir
frávísund	frávísun
frávitu	fráveitu
frax	frá
fraþ	fram;frá
frbær	frábær
fre´tt	frétt
freændi	frændi
freðað	friðað
freðamaður	ferðamaður
freðamenn	ferðamenn
freðniri	freðnir
freg	frek
fregar	frekar
freggn	fregn
freglega	freklega
frégnir	fregnir
freiða	freyða
freiðivíni	freyðivíni
freiðnir	freðnir
freigát	freigáta
freis	freys
freisast	freistast
freist	freista
freittir	þreyttir;breyttir
fréittit	fréttist;fréttir
freitur	feitur
freja	freyja;freka
freju	freyju;freku
frék	frek
frekar,	frekar
frekarí	frekari
frekarin	frekari
frekatur	frekastur
frekka	drekka
frekkir	frekir
frekklands	frakklands
frekknótt	freknótt
frekkur	freknur
freklu	freknu
freknuð	freknur;freknótt
frelsanna	fresanna
frelsisstyttuni	frelsisstyttunni
frelsisstyttunini	frelsisstyttunni
frelsissvifitng	frelsissvipting
frelsissvifitngu	frelsissviptingu
frelsissvipitng	frelsissvipting
frelsissvipitngu	frelsissviptingu
frelsystyttuni	frelsisstyttunni
fremleið	framleið
fremorðið	framorðið
fremum	fremjum
fremuyr	fremur
frén	dren
frendi	frændi
frenmst	fremst
frent	prent;fernt
freslanna	fresanna
fresnuð	frestuð
fressu	pressu;dressum
frestunnarárátta	frestunarárátta
frét	frétt
fretilskrá	ferilskrá
frétir	fréttir
fretnir	fregnir
fretr	fretir;fretar
frètt	frétt
frettablað	fréttablað
frettaði	frétti;fretaði
frettar	fréttar
fréttatimanum	fréttatímanum
fretti	freti;frétti
frettið	fretið
frettir	fréttir
fréttk	frétt
fréttur	fréttir
freud	fremd
freund	ferund;frændi
freur	Freyr
freyðast	freyða
freyja]	freyja;Freyja
freysta	freista
freystandi	freistandi
freystingar	freistingar
freystnig	freisting
freysts	frests;freista;freistast
freyttur	þreyttur
freytur	breytur
fri	frí
friðaamur	friðsamur
friðaðans	friðaðan;friðaðs
friðanir	friðaðir
friðapipa	friðarpípa
friðapípa	friðarpípa
fríðapípa	friðarpípa
fríðarpípa	friðarpípa
friðarsuæan	friðarsúlan
friðarsul	friðarsól;friðarsúla
friðarsula	friðarsinna;friðarsúla
friðarsulan	friðarsúlan
friðarsúlan.	friðarsúlan
friðarsulum	friðarsinnum;friðarsúlum
friðarsulur	friðarsúlur
friðasam	friðsamt;friðsama
friðasama	friðsama
friðasti	fríðasti
friðgeri	Friðgeiri;Friðgeir
friðiur	friður
friðlendi	friðlandi
fríðnum	fríðum;friðinum
friðny	Friðný
friðr	friður
fríðr	fríður
fridrik	Friðrik
friðrík	Friðrik
fríðrik	Friðrik
fríðsæll	friðsæll
friðsalega	friðsamlega
friðsalegur	friðsamlegur
friðsamuliðug	friðsamleg;friðsamlegur
friðsmmur	friðsamur
friðt	frið;friður
friðuz	friður
friðþæjing	friðþæging
friétta	frétta
frífu	fríu;drífu;Drífu
frigeir	Friðgeir
frígu	fríu
frihet	fríheit
frihg	frigg
frihöfn	fríhöfn
fríhófnin	fríhöfnin
fríhöfninn	fríhöfnin
frii	fríið
friiđ	fríið
friið	fríið
fríid	fríið
fríiđ	fríið
fríidagar	frídagar
fríindin	fríðindin
frijar	fríar
fríjindi	fríðindi
frillun	frilluna
frilskrá	ferilskrá
frímeri	frímerki
frimerki	frímerki
frímermi	frímerki
frími´nu´tur	frímínútur
frímímunutur	frímínútur
frímín	frímínútur;prímin
fríminotur	frímínútur
frimínútur	frímínútur
fríminutur	frímínútur
fríminutúr	frímínútur
fríminútur	frímínútur
frímínutúr	frímínútur
frímínútuyr	frímínútur
frímónutur	frímínútur
frimunútur	frímínútur
frímunutur	frímínútur
frímúrar	frímúrara
frímúri	frímúrari
frínerki	frímerki
fringra	fingra
fringrafa	fingrafar
fringrafar	fingrafar
fringrafari	fingrafari
fringrafor	fingraför
fringraforum	fingraförum
fríni	fríi;gríni
fririk	friðrik
frisamur	friðsamur
frísir	frískir
frískjandi	frískandi
frísland	fríland
fríslendingur	Íslendingur
fríss	frís
fríssur	frískur
frist	fryst
fríst	frýst
fristum	frystum
fristund	frístund
frísu	frysu;fríu
frít	frítt
friti	afriti
fritid	afritið
fritið	afritið
frítimi	frítími
fríujunar	frýjunar
friun	friðun
frjals	frjáls
frjáls·legur	frjálslegur
frjálsli	frjálsri
frjálslindi	frjálslyndi
frjár	fjár
frjárls	frjáls
frjast	ferjast;frjálst
frjòr	frjór
frjòsa	frjósa
frjósinnum	fjósunum
frjósinum	frjósi;fjósinu;fjósunum
frl	frá;fræ
frlega	ferlega
frmhj´	framhjá
frmhjá	framhjá
frmúrskarandi	framúrskarandi
frna	farna;fyrna
froð	froða
froda	froða
fróda	fróða
fróðastu	fróðastur
frodi	fróði
frøði	fræði
fróðinum	friðinum
froðlegur	fróðlegur
fróðlegutr	fróðlegur
fróðleika	fróðleik
fróðleikan	fróðleikur
fróðleikann	fróðleikinn
fróðunni	froðunni
froðusnak	froðusnakk
froenka	frænka
frök	fröken
fröke	fröken
frokinni	frækinni;afrokinni
frökkun	frökkum;Frökkum
fröknuð	flöknuð
fról	fól;ról
frola	róla;fóla
fröllur	frollur
frómdu	frömdu
fron	frón
fröndkum	frönskum
frönks	frönsk
frönku	frönsku
fronsk	frönsk
fronskur	franskur;franskar
fropa	ropa
frorkkun	flokkun;forkunn
frorkunn	forkunn
frósið	frosið
fröskur	froskur
frosnað	frosnar;frosið
frösnar	frosnar
frosnuð	frosin
frostkvaldann	frostkaldan;frostkaldann
frostpinnarnair	frostpinnarnir
frostpinnarnis	frostpinnarnir
fróstrurnar	rósturnar;fóstrurnar
frostu	frosti
frósturnar	rósturnar;fóstrurnar
frostvörum	frostvörnum
frottalegur	hrottalegur
frrð	ferð
frsasa	frasa
frsta	fyrsta;frysta
frsti	fyrsti;frysti
frstur	frystur;fyrstur
fru	frú
fruðust	furðuðust
fruggin	fruggi
frugtaði	fruktaði
fruki	freki
fruktari	fruktaðri
fruktósi	frukti;frúktósi
frulla	fulla
frumæegt	frumlegt
frumál	frummál
frumasta	fruma;fremsta
frumbyggari	frumbyggi
frumbyggji	frumbyggi
frumbyggjur	frumbyggjar
frumfluttning	frumflutning
frumfluttningur	frumflutningur
fruminnn	frumminnin;frumminni
frumkvæðni	frumkvæði
frumlegathæfi	frumleg;athæfi
frumlegtathæfi	frumlegt;athæfi
frúmlegur	frumlegur
frumlkegt	frumlegt
frumm	frum
frummbygg	frumbyggi
frummskór	krummaskór;frumskógur
frúmrit	frumrit
frumskór	frumskógur
frúmskór	rúmsjór;frumskógur
frumue	frumur
frumurfruma	frumur;fruma
frumþáttun	frumþáttum
frún	frúin
frúnar	frúrnar
frunki	franki;runki
frunt	fyrnt
frus	fruss
frús	frú;frís
frussá	frussa
frussaist	frussaðist
frussana	frussanna
frussár	frussar
frust	fryst
frusy	frusu
frút	frú;frítt
frúu	fríu
frýa	fría
frýað	fríað
fryða	friða
frýða	fríða
frýðs	frýs;fríðs
frýdti	prýddi
fryður	friður
fryggð	frygð
frygn	frygð
frýgsað	frýsað
fryja	freyja
fryki	rykið
frykið	rykið
frýlista	frílista
frýndar	frýnar
frýnilegur	frýnilegur
fryslur	frystur
frýsni	frýsi
frystikirka	frystikerja
frystikysta	frystikista
frystirr	frystir
frýsun	frýsuna
frýtt	frítt
fsetyum	fetum;setjum
fsgna	fagna
fskúta	skúta
fsrnir	farnir
fsrs	fars;fara
ftauga	flauga;auga
fúaða	fúnaða
fuði	furði;fuðri
fuðrarðu	fuðraðu
fuðrast	furðast
fuðrastu	furðastu
fúgaði	kúgaði
fuglbjörg	fuglabjörg
fuglbjörgum	fuglabjörgum
fuglq	fugl
fugnéri	fundéri
fúgs	fús
fui	funi
fuji	funi
fuk	fúl
fúk	fúsk
fúkkaðar	púkkaðar
fúkll	fúll
ful	full;fúl
fula	fúla
fúlaní	fúlan
fulanna	fuglanna
fúldið	fúlið
fulga	fúlga
fúlgað	fúlga
fúlgaða	fúlgraða
fúlgaði	fúlgraði
fulgert	fullgert
fulginn	fuglinn;fylginn
fulgjandi	fylgjandi
fulgjast	fylgjast
fulit	fullt
fulkomnlega	fullkomlega
fulkomnu	fullkomnu
fullara	fullar;fyllra
fuller	fullar;fullir
fullgil	fullgilt;fullgild
fullgilðar	fullgildar
fullirða	fullyrða
fullkaraður	fullkláraður
fullkomleg	fullkomlega
fullkomlegast	fullkomlega
fullkomlegur	fullkominn
fullkomnlega	fullkomlega
fullkunna	fullunna
fullkunnt	fullkunnugt
fullljöst	fullljóst
fulllorðnum	fullorðnum
fulllur	fullur
fúlllýndur	fúllyndur
fullnægjanfi	fullnægjandi
fullning	fullni
fullningar	fullnægingar
fullningarhur	fulningahurð
fullningarhurð	fulningahurð
fullnun	fullnuð
fullnýandi	fullnýtandi;fullnægjandi
fullnysta	fullnusta
fullorð	fullorðið
fullorði	fullorðin
fullorðinnir	fullorðnir
fullörðna	fullorðna
fullorðnari	fullorðnar;fullorðinni
fullorðninn	fullorðinn
fullorðnnir	fullorðnir
fullorðum	fullorðnum
fullornum	fullorðnum
fullot	fullt
fullr	fullur;fullir
fullsadan	fullsaddan
fulltkomið	fullkomið
fulltræui	fulltrúi
full­trúa	fulltrúa
fullusér	fullur
fullut	fullur
fullvisað	fullvissað
fullyrðan	fullyrða
fullyrðinn	fullyrðing
full­yrðir	fullyrðir
fullyrður	fullyrðir
fulna	gulna;fullna
fulnaðu	fullnaðu;gulnaðu
fulorðin	fullorðin
fúlsma	fúlsa
fult	fullt
fultaðan	sultaðan
fulttur	fluttur
fumastar	fumar;fimastar
fumb	fum
fuminn	flauminn
fumma	fimma
fumme	fimm;fimma
funbdur	fundur
fundaboð	fundarboð
fundagerð	fundargerð
fundagerði	fundargerðin
fundagerður	fundargerðir
fundari	fundar
fundarskyrsku	fundarskýrslu
fundastjóri	fundarstjóri
funder	fundar;fundir
fundherbergi	fundarherbergi
funðið	fundið
fundq	fund;funda
funds	fundar
fundst	fundist;fundust
fundunr	fundur
fúndur	fundur
funf	fund
funfur	fundur
fungir	ungir
funndi	fundi;fyndi
funndu	fundu;finndu
funnu	fundu;finni;Finni;runnu;unnu
funst	finnst
funtir	fundir
funuk	funum
fupið	fipið
fupo	fao
fur	fyrr
fúrað	flúrað
fúraði	flúraði
furðak	furða
furðarðu	furðar
furðastu	furðast
furðirnar	afurðirnar
furdu	furðu
fúrðu	furðu
furðug	furðu
furðuhreimur	furðuheimur
furðurhreimur	furðuheimur
fúrkar	forkar
fursk	fersk
furstur	fyrstur
fus	fús
fusa	fúsa
fuskur	fiskur
fussk	fusk
fusst	fuss
fussu	fussum;fuss;fussi
futt	flutt
futtanum	puttanum;guttanum
futtuð	fluttuð
fuulum	fullum
fuvl	full;fugl
fuxan	furan
fuþark	fúþark
fvelja	velja
fvötnum	vötnum
fwgurð	fegurð
fwldur	fýldur;feldur
fybbst	ybbast;finnst
fýda	fýlda
fyðin	fuðin
fydinn	fyndinn
fyðjur	gyðjur
fydna	fyndna
fyfta	lyfta;vifta
fygdarmaður	fylgdarmaður
fygdimaður	fylgimaður
fygja	fylgja
fyglja	fylgja
fyirlestur	fyrirlestur
fyirr	fyrir
fyjgla	fygla
fykgist	fylgist
fykruðu	fikruðu
fýlað	fílað
fýlaðist	falaðist
fýlful	fylfull
fýlfulk	fylfull
fylga	fylgja
fylgast	fylgjast
fýlgdist	fylgdist
fylgdja	fylgja
fylgdt	fylgd;fylgt
fylgdti	fylgdi
fylgdyst	fylgdist;fylgdust
fylggi	fylgi
fylggja	fylgja
fylgia	fylgja
fylgiskal	fylgiskjal
fylgiskjál	fylgiskjal
fylgisköl	fylgiskjöl
fýlgja	fylgja
fylgjas	fylgjast
fylgji	fylgi
fylgjin	fylgin
fylgjist	fylgist
fylgldist	fylgdist
fylgli	fylgi;fylgni
fylgstu	fylgistu
fylgyskali	fylgiskjali
fylgyskall	fylgiskjal
fylgyskjal	fylgiskjal
fylgyskjöl	fylgiskjöl
fylia	fylla
fýlindi	fýlandi
fyllabitta	fyllibytta
fylleri	fyllerí;fyllirí
fyllgjist	fylgist
fyllibitta	fyllibytta
fylly	fullu;fylli
fylma	filma
fylsma	filma;fylgsna
fylstu	fyllstu;fylgstu
fyltist	fylgdist;fylltist
fyltst	fylgst;fylltist
fylum	fyljum
fylun	fylin
fymi	fimi
fymm	fimm
fymmti	fimmti
fymti	ymti;fimmti
fynd	fund
fyndd	fyndi
fynddin	fyndin
fynddinn	fyndinn
fyndim	fyndin
fyndin]	fyndin
fyndinar	fyndinnar
fyndinnn	fyndinn
fyndivv	fyndinn
fyndynn	fyndinn
fyngur	fingur
fynn	finn
fynna	finna
fynnast	finnast
fynndin	fyndin
fynndist	fyndist
fynns	finns;finnst
fynnst	finnst
fynnt	fyrnt
fynt	fínt;fyrnt
fyölskylda	fjölskylda
fyp	fyl
fyribæri	fyrirbæri
fyriburi	fyrirburi
fyrigerfðu	fyrirgefðu
fyriirlestur	fyrirlestur
fyrimynd	fyrirmynd
fýrír	frír
fyrir·bæri	fyrirbæri
fyriræki	fyrirtæki
fyrirbyggjun	fyrirbyggjum
fyrirferðalítill	fyrirferðarlítill
fyrirferp	fyrirfer;fyrirferð
fyrirframm	fyrirfram
fyrirfrma	fyrirfram
fyrirgefði	fyrirgefðu
fyrirkestur	fyrirlestur
fyrirkomulaf	fyrirkomulag
fyrirkomulög	fyrirkomulag
fyrirlagstur	fyrirlestur
fyrirlest	fyrirleist
fyrirlesta	fyrirlestra
fyrirlestar	fyrirlestrar
fyrirlestrun	fyrirlestrum
fyrirlestrur	fyrirlestur
fyrirlestursalur	fyrirlestrarsalur
fyrirlesur	fyrirlestur
fyrirmælið	fyrirmæli
fyrirmli	fyrirmæli
fyrirnefnds	fyrrnefnds
fyrirnefndt	fyrrnefnd;fyrrnefnt
fyrirrunna	fyrirruna
fyrirspurði	fyrirspurn
fyrirspurt	fyrirspurn
fyrirstað	fyrirstaða
fyrirstaður	fyrirstöður;fyrirstaða
fyrirt´ki	fyrirtæki
fyrirtæk	fyrirtæki
fyrirtæk8u	fyrirtækju;fyrirtæki
fyrirtæli	fyrirtæki
fyrirtí	fjörutíu
fyrirtöku	fyrirtökum
fyrirunna	fyrirruna
fyrirvaralsust	fyrirvaralaust
fyristi	fyrsti
fyritæki	fyrirtæki
fyrivari	fyrirvari
fyrnefndur	fyrrnefndur
fyrnefns	fyrrnefnds
fyrntar	fyrndar
fyrranálið	fyrramálið
fyrrir	fyrir
fyrrirtæki	fyrirtæki
fyrrnenfns	fyrrnefnds
fyrrsti	fyrsti
fyrrumnefnd	fyrrnefnd
fyrrumnefnnd	fyrrnefnd
fyrrumnefnndar	fyrrnefndrar
fyrrvarandi	fyrrverandi
fyrrveranndi	fyrrverandi
fyrrverrandi	fyrrverandi
fyrsata	fyrsta
fýrst	fyrst
fyrstjur	fyrstur
fýrstur	fyrstur
fyrtján	fitjár;fjórtán
fyrtsa	fyrsta
fyrtsi	fyrsti
fyrtsur	fyrstur
fyruð	feyruð
fyrurgefa	fyrirgefa
fyrverrandi	fyrrverandi
fýs	fús
fýsaði	fýsti
fýsískan	fasískan
fysískt	fasískt
fýssni	fýsni
fystur	fyrstur
fýstusk	fýstust
fyt	fit
fytsur	rytsur
fyttaði	fattaði
fzrsti	fyrsti
fþætti	þætti
fþrír	þrír
fþruðji	þriðji
g-olf	golf
g;tu	gætu
g´ð	góð
g´ði	gæði
g´ðir	góðir
g´ti	gæti
ga	gá
ga,al	gamall
ga,all	gamall
gaangur	gangur
gab	gaf
gabíel	Gabríel;Gabriel
gabrél	Gabríel;Gabriel
gabrélla	Gabríella;Gabriella
gabri	gambri
gabriéla	Gabríela;Gabriela
gabý	gabb
gadra	galdra
gæ	gær
gæætis	gætis
gæafuður	gæsafiður
gæatt	gætt
gæatu	gætu
gæðana	gæðanna
gæðastiki	gæðastigi
gæekvöld	gærkvöld
gæftalwysi	gæftaleysi
gæfumunir	gæfumunur
gægæðist	gægðist
gægði	gæði
gægdust	gægðust
gægir	gægist
gægji	gægju
gægstir	lægstir
gæjari	gæjar
gæji	gæi
gæjinn	gæinn
gæjist	gægist
gæjn	gæja
gæjr	gær
gæk	gær
gælar	gæla
gælts	gælt
gæludýrini	gæludýrinu
gæludyur	gæludýr
gælun	gælum
gælurna	gælurnar
gæminna	gæmanna
gæmul	gömul
gæng	gang
gænmetis	grænmetis
gænmetisréttur	grænmetisréttur
gæo	gær
gæqtu	gætu
gærjarnir	gæjarnir
gæsasteggur	gæsarsteggur
gæsindi	gæsinni
gæslu­v­arðhaldi	gæsluvarðhaldi
gæsunar	gæslunnar
gætan	gæta
gætiþ	gæti
gæums	gaums
gæumst	gæfumst
gæyur	gætur
gafa	gaf;gefa;grafa
gáfadðs	gáfaðs
gáfaðu8r	gáfaður
gafaður	gáfaður
gàfaður	gáfaður
gafal	gaffal
gafall	gamall;gaffall
gafáll	hafáll
gáfall	áfall
gafalli	gamalli
gaff	gaf
gaffel	gaffal
gafflall	gaffall
gafflin	gaffli
gafflinn	gaffalinn
gafguð	göfguð
gáfir	gáfur
gafirnar	gjafirnar
gaflast	gafla
gáfnaði	gáfaði
gáfsður	gáfaður
gáfug	gáfu
gáfumenni	gáfumanni
gafur	gefur
gagangrunnur	gagnagrunnur
gagn·rýninn	gagnrýninn
gagnaferjun	gagnaferjuna
gagnagrun	gagnagrunn
gagnagrún	gagnagrunn
gagnagrúnn	gagnagrunn
gagnana	gagnanna
gagnfræðiskóla	gagnfræðaskóla
gagnga	ganga
gagngeet	gagngert
gagngrýna	gagnrýna
gagngrýni	gagnrýni
gagnrína	gagnrýna
gagnríndur	gagnrýndur
gagnrínn	gagnrýnn
gagnrúnduð	gagnrýnduð
gagnrýkir	gagnrýnir
gagnryna	gagnrýna
gagnrýnilaust	gagnrýnislaust
gagnrynn	gagnrýnn
gagnrýnnin	gagnrýnin
gagnrýnninar	gagnrýninnar
gagnrýnum	gagnrýnum
gagnsært	gagnsætt
gagnsæt	gagnsætt
gagnsæur	gagnsæir
gagnskör	gangskör
gagnýta	hagnýta
gagnýtt	hagnýtt
gagryna	gagrana
gagryni	gagnrýni
gagrýni	gagnrýni
gagrýnin	gagnrýnin
gagrýninn	gagnrýninn
gagrynni	gagnrýnni
gahnvart	gagnvart
gakkt	gakktu
gákrist	gárist
gáktu	gátu
galannar	glannar;galinnar
galasti	galnasti
galdrabok	galdrabók
galdróttur	göldróttur
galdu	galdur
galería	gallería
galg	gang
galga	ganga
galíon	gallon
gallanskur	gallneskur
gallítaður	gallaður
gallitarefni	galllitarefni
gallur	allur
galnaða	gulnaða
gálp	gjálp
gálsma	gálma
galuð	galið
galþþ	gals
gama	gáma
gama,l	gamall
gamaæ	gaman
gamal	gamall
gamaliel	Gamalíel
gamalll	gamall
gamallt	gamalt
gamalsdags	gamaldags
gamalur	gamalær
gamaninu	gamninu
gamanl	gaman;gamall
gamann	gaman
gamatll	gamall
gambol	Gabon
gameliel	Gamalíel
gamelíel	Gamalíel
gamell	gamall
gamil	gamli
gamir	gamlir
gamlann	gamlan
gamlár	gamlar
gamlársdagurt	gamlársdagur
gamll	gamall
gamlli	gamli
gammak	gamma
gammal	gamall
gammall	gamall
gammalt	gamalt
gammla	gamla
gammlur	gammur
gammon	mammon
gámmur	gámur
gamnan	gaman
gamqll	gamall
gamsana	gemsana
gamsanna	gasanna
ganaga	ganga
ganastu	gagnastu
gandgan	gangan
gandhafi	handhafi
gánga	ganga
gangaa	ganga
gangaferd	gangnaferð
gangaferð	gangnaferð
gangamuni	gangamunni
gángan	gangan
gangatur	ganglatur
gangdi	gangi
gangdyr	gangadyr
gangdyrna	gangadyrnar
gángdyrnar	gangadyrnar
gangfa	ganga
ganglegar	gagnlegar
ganglimuj	ganglimur
gangq	gang
gangstigunum	gangstígunum
gangtegundur	gangtegundir
ganka	ganga
gannu	gunnu
gánol	gál
ganrýni	gagnrýni
gantisti	gatisti
ganuða	gnauða
gapastikk	gapastokk
gapis	gaps
gáratug	áratug
gard	garð
garđ	garð
gardabæ	Garðabæ
garđar	garðar;Garðar
garðariíki	Garðaríki
garðin	garðinn
garđinn	garðinn
gardinum	garðinum
garđinum	garðinum
gardinur	gardínur
garðinur	garðinum
garðist	gerðist
garðo	garð;garði;Garði
garđs	garðs;Garðs
garðshús	garðahús
garđsins	garðsins
garđum	gerðum;görðum
gardur	garður
garđur	garður
garðurin	garðurinn
garðut	garður;Garður
garfu	garfa
gargla	garga
garinnar	gárinnar
gárkist	gárist
garnu	garni
gásað	gása
gásan	gása
gáskan	gáskann
gáskir	gásir
gaslara	göslara
gaslitur	graslitur
gasreiti	grasreiti
gassin	gassinn
gassinni	gassinn
gastr	gast
gastuð	guð
gastugeta	gaslugta
gastur	gestur
gât	get
gäta	geta
gátann	gátan
gateri	gatari
gatinum	gatinu
gátis	gætis
gatlæti	atlæti
gatu	gætu;gátu
gaua	Gauja
gauda	gauta;Gauta
gauðn	auðn
gaufan	gufan
gaufana	gaufara
gaujin	gauðin
gaumin	gauminn
gaumina	gauminn
gaungum	göngum
gauninn	gaurinn
gaunu	gaupu
gaup	kaup
gaurinni	gaurinn
gaurinnn	gaurinn
gausins	gaursins
gaymi	geymi
gays	gys
gbríel	Gabríel;Gabriel
gðmundur	Guðmundur
gdúr	dúr
ge,ngur	gengur
ge3rðinni	gerðinni
geatbað	getað
geddi	gleddi
géds	geðs
geek	gekk
geekk	gekk
geeta	geta
gefiru	gefir
gefli	gefi
geflir	gefnir
gefq	gef
gefsa	gefa
gefýra	gefara
geg	gegn
gegba	gegna
gegl	gegn
gegnaði	gagnaði
gegngdarlaus	gegndarlaus
gegngdu	gegndu
gegnim	gegnum
gegntak	gagntak
géh	gré
geiða	greiða
geigara	geigar
geignvælegu	geigvænlegu
geilaspilar	geislaspilari
geilaspilarar	geislaspilarar
geilun	geislun
geimforin	geimförin
geimsd	geims
geimsi	geimi
geimsla	geymsla
geimslá	geymsla
geimslu	geymslu
geind	greind
geinda	greinda
geingum	gengum
geinun	geipun
geinuna	ginuna
geinvænlegu	geigvænlegu
geirnist	girnist
geirur	geirum
geirvart	geirvarta
geirvört	geirvörtu
geisaða	geisað
geisaðo	geisað
geisip	geisp
geisladikur	geisladiskur
geisladiski.	geisladiski
geislaðiskur	geisladiskur
geisladríf	geisladrif
geislarpilarar	geislaspilarar
geislarpilararnir	geislaspilararnir
geislidisk	geisladisk
geislidiski	geisladiski
geispaa	geispana
geispqðu	geispuðu
geist	geyst
geistist	geystist
geistugur	teistugur
geistumst	geystumst
geisu	geisa
geithéði	geithéðni
géka	góka;bóka
gékk	gekk
gémsla	geymsla
gén	gen
gengdarlaus	gegndarlaus
gengdi	gegndi
géra	gera
gérða	gerða
gérðu	gerðu
gerfi	gervi
gét	get
gétur	getur
geysar	geisar
geyspa	geispa
ghana	Gana
gíftur	giftur
gífunar	gufunar
gífurkega	gífurlega
gífuryðri	gífuryrði
gígbrú	gígbrún
gígin	gíginn
gígjarfoss	Gýgjarfoss
gígka	gígja
gígt	gigt
gíkklandi	Grikklandi
gílas	glas
gílau	gíla
gíli­nur	gílinur
gill	gil
gíms	gríms
gínaði	grínaði
gínunar	gínurnar
gírafann	gíraffann
gíraffí	gíraffi
gírafi	gíraffi
gírafinn	gíraffinn
gíranu	gírana
gíru	gír
gírunar	grunar
gis	gys
gísk	grísk
gíslasonur	Gíslasonar
gísnunar	gisnunar
gístu	gistu
gítaleikari	gítarleikari
gitar	gítar
gítarleikar	gítarleikari
gítarlika	gítarleiks
gítarliki	gítarleik
gítarrin	gítarinn
gjà	gjá
gjaf	gaf;gjöf
gjeggjað	geggjað
gjöð	gjörð
gjóf	gjöf
glad	glað
gladur	glaður
gleima	gleyma
gleipa	gleypa
glima	glíma
glóðurauga	glóðarauga
gluggagæjir	gluggagægir
gluggan	gluggann
gluggasilla	gluggasylla
gluggin	glugginn
gluggu	gluggi
glyma	gleyma
go	og
go´tt	gott
go∂ur	gotur
góáður	góður
god	góð
gód	góð
góđ	góð
gòð	góð
góð7	góð;góði
góðaan	góðan
goðaf	goða;goðafræði;góða
góðafræði	goðafræði
goðafræðii	goðafræði
goðam	goða;goðann
goðan	góðan
góđan	góðan
góðast	góða
góðgæit	góðgæti
goðgæti	góðgæti
góðgerðarstarf	góðgerðastarf
goðir	góðir
góðmál	góðmálm
goðorðsmaðr	goðorðsmaður
goðra	góðra
goðrar	góðrar
goðsfræði	goðafræði
góðsögn	goðsögn
goðu	góðu
góðue	góðu
gódum	góðum
godur	góður
goður	góður
gódur	góður
gódùr	góður
góđur	góður
gòður	góður
gõður	góður
góðurglaður	góðglaður
góðut	góðu;góður
göfa	gefa
gófl	gólf
göfla	göfgina
göfuft	göfugt
gögan	gögn
gögaur	gögur
gögm	gögn
gögnun	gögnum
gógur	góður
gögura	gögur
gögurð	göguð
gögurn	gögur
gögurr	gögur
gökkhærð	dökkhærð
góld	gólf
göldróttann	göldróttan
góldvild	góðvild
gólðvild	góðvild
góletta	gletta
gólfiny	gólfinu
gólfmótta	gólfmotta
gólmu	gálmu
gómez	góms
gómin	góminn
gömly	gömlu
gomsætur	gómsætur
gómsat	gómsæt
gömull	gömul
gómun	gómum
gömur	gömul
göngaferð	gönguferð
göngtur	göngur
gönguf	göngu
göngufélag	göngufélagi
göngufer	gönguferð
gönguferđ	gönguferð
gönguferð-	gönguferð
gönguferðina:	gönguferðina
gönguferður	gönguferðir
gönguleid	gönguleið
göngunur	göngunum
göngur	göngur
göngurind	göngugrind
göngurtur	göngutúr
göngurtúr	göngutúr
gönguskor	gönguskór
góngutúr	göngutúr
göngutur	göngutúr
goöfræði	goðfræði;goðafræði
górmur	gormur
górrum	gerrum
góssu	góssi
gótt	gott
gotúr	gotur
gouður	guður
goût	got
goyi	gosi
goþaula	golaula
gpáskar	páskar
gptt	gott
gqffall	gaffall
gqmall	gamall
gr-is	grís
gr´r	grár
gr´ta	gráta
gra	grá
gráaan	gráan
gräata	gráta
grad	grand
grada	granda
grádandi	grátandi
gráðin	ráðin
graðkan	graðka
graðkann	graðka
gráðung	gráðug
gráðungur	gráðugur
gráðuostur	gráðaostur
grádur	gráður
grádúr	gráður
gráðurs	gráður
græaðugur	gráðugur
græaj	græja
græant	grænt
græar	grænar
græata	græta
græðamm	græða
græeðum	græðum
græen	græn
græeti	græti
grægja	græja
grægjur	græjur
græinn	grænn
græmenti	grænmeti
græmetis	grænmetis
græmetli	grænmeti
græmetti	grænmeti
græmt	grænt
græmti	græti
græneti	grænmeti
grænjaxt	grænjaxl
grænkast	grænka
grænkun	grænkuna
grænlænsk	grænlensk
grænlandingi	Grænlendingi
grænlandingur	Grænlendingur
grænlandur	Grænlandi
grænmat	grænmeti
grænmeiti	grænmeti
grænmet	grænmeti
grænmetisæt	grænmetisæta
grænmeto	grænmeti
grænnstór	græntór
grænskur	grænkur
grænt.	grænt
grænusta	grænasta
græoðursetti	gróðursetti
græpana	grípana
græskir	ræskir
grætaða	grætta
grætajða	græjaða
grætala	græta
grætut	grætt
gráfa	grafa
grafalvalegur	grafalvarlegur
grafarvarlegur	grafalvarlegur
graffíu	grafít
grafía	grafa
grafíj	grafík
gráfikjur	gráfíkjur
grafín	grafin
grafíu	grafít
grafkyr	grafkyrr
graftarbólar	graftarbóla
graham	grashaf
gralinum	gralnum
grallann	gallann
grallnu	gralinu
grammar	gramma
granatepri	granatepli
grandaaus	grandalaus
grandirs	grandir
grang	gang
granhár	granahár
granmur	grannur
grannnur	grannur
grannue	grannur
granola	granóla
gransan	granan
grant	grannt
grantir	grannir
grasflat	grasflöt
grási	grasi
grásinu	grasinu
grask	gras
graski	grasi
gráskin	gráskinn
graskinu	grasinu
graskur	grasker
grásog	grátsog
grassið	grasið
grastann	rastann
grasystingur	grasaystingur
grat	gat
grata	gráta
grátam	gráta
grátbeðija	grátbiðja
grátbeið	grátbeðið
grátbeiðir	grátbeiðnir
gratinni	grátinni
gratta	grótta
gráturs	grátur
graufst	raufst
graulir	gaulir
graunar	raunar;gránar
graunara	grafnara
grauns	gruns
grautfúgin	grautfúin
graws	gras
grðja	græja
gre9iðslusedill	greiðsluseðill
greann	greiðann
greða	greiða
greddara	greiddara
gredduð	greidduð
gréðuði	gréruði
green	grein
grefan	grafan
grefillin	grefillinn
grefilling	grefillinn
grefist	gefist
greiá	grein
greida	greiða
greiđa	greiða
greiðaðir	greiðkaðir
greiðsl	greiðslu
greiðslusedill	greiðsluseðill
greifu	greifi
greim	grein
greimfarið	geimfarið
greinager	greinargerð
greinagrerð	greinargerð
greinamerkjasetning	greinarmerkjasetning
greinanar	greinarnar
greinarerð	greinargerð
greinarmerkum	greinarmerkjum
greinða	greiða
greindann	greindan
greindarhöfundur	greinarhöfundur
greinlegri	greinilegri
greinn	grein
greinnina	greinina
greinur	greinir
greisla	greiðsla
greitar	greinar
greiüa	greiða
grekkara	greikkar
gremj	gremju
gremjadt	gremjast
gremjasy	gremjast
gremlinginn	gemlinginn
grend	grennd
grendara	grandara
grendarkynning	grenndarkynning
grendinni	grenndinni
grengjandi	grenjandi
greninelur	grenimelur
grenndarennsla	grenndarvinnsla
grennsla	rennsla
grenslast	grennslast
grera	gera
gresti	gesti
gresugan	grösugan
grettue	grettu
greyðq	greið
greyfynjunni	greifynjunni
greyjið	greyið
greymi	gleymi
greymjulegt	gremjulegt
greynast	greinast
greyning	greining
greynir	greinir
gríðalega	gríðarlega
griðan	greiðan
griðarleg	gríðarleg
griðarlega	gríðarlega
griðarsáttmáli	griðasáttmáli
griðarstaður	griðastaður
griddur	greiddur
griðingum	girðingum
griðnast	gripnast
griðnist	greiðist
grief	gref
grífa	grípa
griff	grip
griffa	griffla
grifft	griffli
griflar	griplar
gríikki	Grikki;grikki
griki	Grikki;grikk;grikki
grikkar	Grikkir;grikkir
gríkki	Grikki;grikki
grikkki	Grikki;grikki
grikklamd	Grikkland
gríkkland	Grikkland
gríkklandi	Grikklandi
gríkland	Grikkland
grili	grilli
grílla	grilla
grílukerti	grýlukerti
grilum	grillum
grílurnar	grýlurnar
grimdarverk	grimmdarverk
grimmilegue	grimmilegu
grimr	grimm;Grímur
grimsey	Grímsey
grímur…•	Grímur
grinari	gripnari
grindavik	Grindavík
gríndavik	Grindavík
grinði	griði
grinðing	grinding
grinðinguna	grindinguna
grindinna	grindina
grindun	grindum
gríndur	grindur
grinf	grind
grinhir	grindir
grinilega	greinilega
grinilegt	greinilegt
grínkaði	grínaði
grínkaðo	grínað
grinlegar	greinilegar
gríoa	grípa
grìpa	grípa
gripluni	griplunni
gripping	gripning
gris	grís
grísin	grísinn
grísins	gríssins
grísjun	grisjun
grísjún	grisjun
grísjur	grisjur
grisku	grísku
grísla	gísla
grísnisti	grínisti
grissn	grisin
grístarstór	gríðarstór
grísu	grísku
grisun	grisjun
grit	girt
grít	grín
grjemjast	gremjast
grjórn	grjón
grjótt	grjót
grjótur	grjóturð
grø	gr.
groa	gróa
gróaðinn	gróðinn
gróðarhús	gróðurhús
gróðrastöð	gróðrarstöð
gróðravon	gróðavon
gröðs	grös
groðurinn	gróðurinn
gróðurvermd	gróðurvernd
gröfl	gröf
groflega	gróflega
gröfta	gröft
gröfti	gröft
gröfts	gröft
gröftud	gröftur
groftur	gröftur
gróftur	grófur
grokinni	krokinni;rokinni
gromsun	gromsum
grömsun	grömsum
gronkir	grunkir
groq	grot
gros	gross
gróssi	góssi
grotæta	grotta
gróthól	grjóthól;Grjóthól
grótinn	grátinn
grotlaða	grotnaða
grrunnskólaaldur	grunnskólaaldur
grubbing	grubbi
grúðursetti	gróðursetti
gruðust	gröðust
grufđi	grúfði
grufði	grúfði
grumann	gumann
grumanna	rumanna
grumsemdir	grunsemdir
grunaðu	grunaður
grunarðra	grunaðra
grunaru	grunar
grunding	grundin
grundvallaatriði	grundvallaratriði
grundvðllur	grundvöllur
grundvellir	grundvelli
grunmynd	grunnmynd
grunnsuð	grunnuð
grunnvöllur	grundvöllur
grupp	grepp
grútaða	grúnaða
grútsins	grútins
grwiða	griða
grýæukerti	grýlukerti
grybba	gribba
grýðar	gríðar
grýfsað	grúfsað
grygja	gryfja
grýmur	grímur
grýndar	rýndar
grynini	grynni
grynka	grynnka
grynst	grynnst
gryplur	griplur
gryslur	grisjur
grýtaða	grýtta
grýtin	grýti
grýtni	grýti
gryttar	grýttar
gsegja	segja
gtænn	grænn
gtretti	gretti
guasts	gusts
gubjartur	guðbjartur
gud	guð
guðbe	guðbet
guðbel	guðbil
guðbjartir	Guðbjartur
guðbrahdur	Guðbrandur
guðbrandir	Guðbrandur
guðdóm­leg­ar	guðdómlegar
guðinason	Guðnason
guðinna	Guðfinna
guðinur	guðinum
guðjon	Guðjón
guðjón	Guðjón
guðláfur	Guðleifur;gulfur
guðlaugu	Guðlaugu;Guðlaugur
guðles	guðlegs
guðlest	guðlast
guðleyf	Guðleif
guðmudnur	Guðmundur
gudmund	Guðmund
guðmundssonur	Guðmundsson
guðmundunr	Guðmundur
gudmunđur	Guðmundur
guðmuundur	Guðmundur
guðmý	Guðný
guðn	Guðni
guðn´	Guðni
guðn´6	Guðni
gudna	Guðna
guðnæy	Guðný
guđní	Guðni;Guðný
guðnúý	Guðný
guðny	Guðný
gúðný	Guðný
gudr	guður;guð
guðræknis	guðrækni
gudrum	gurum
gudrun	Guðrún
guđrún	Guðrún
guđrūn	Guðrún
guðrun	Guðrún
gúðrun	Guðrún
gúðrún	Guðrún
guðrúnarf	Guðrúnar
guðse	guðs
guðumundur	Guðmundur
guðún	Guðrún
gufaðist	gaufaðist
gug	hug;dug
gugat	gugta
guggan	guggna
guggi	gluggi
gugglanum	glugganum
guggli	guggni
gugguna	guggna
gugleg	dugleg
gugnaði	guggnaði
gugsanir	hugsanir
gukir	gulkir
gukur	gaukur;Gaukur
gulars	gular
gulat	gult
gulfófur	gulrófur
gulfoss	Gullfoss
gulgga	glugga
gulgur	gulur
gulkoss	gullkross
gullar	gular
gullfellga	gullfallega
gullibú	gullabú
gullirs	gullrifs
gullkoss	gullkross
gullslalinn	gullsalinn
gullsnalinn	gullsalinn
gullspalinn	gullsalinn
gullstalinn	gullstólinn
gullủ	gull
gullur	fullur;gulur;gylltur
gullủr	gullúr
gullvesen	gullvespan
gulnast	gulna
gulnu	gullnu
gulrætar	gulrætur
gulríot	gulrót
gulrot	gulrót
gulröt	gulrót
gulróts	gulrót
gulrut	gulrót
gulto	gult
gultót	gulrót
gulue	gulu
guluf	gulu
gumaðan	gumað;gummaðan
gumaður	gumað;gufaður
gumdu	glumdu;komdu
gummíbátur	gúmmíbátur
gummistígvél	gúmmístígvél
gummístigvél	gúmmístígvél
gummístígvélin	gúmmístígvélin
gummulaði	gúmmulaði
gun	gin
gunanr	gunnar;Gunnar
gunar	gunnar;Gunnar
gungugrínd	göngugrind
gunhildur	Gunnhildur
gunlaugur	Gunnlaugur
gunnaði	Gunnari;hannaði
gunnart	gunnar;Gunnar
gunnið	unnið
gunnir	gunnar;Gunnar
gunnlaugr	Gunnlaugur
gunnlaugson	Gunnlaugsson
gunny	Gunný;Guðný;gunni;Gunni
guns	gunnar;Gunnar
guný	Gunný;Guðný
gunþór	Gunnþór
guo	guð
gupið	gapið
guppupest	gubbupest
gurð	gerð
gurði	gerði
gurður	gerður
gurfanna	gufanna
gurgla	gúrgla
gurka	gúrka
gurkan	gúrkan
gurkin	gúrkan
gurmann	guðmann
gurmanna	gumanna
gurt	gert
gurtuna	urtuna
gusana	gusanna
gusans	gusan
gusin	gisin
gusla	busla
guslar	gular
guslara	gulara
guslarar	göslarar
guslari	göslari
gussara	gussaðra
gussari	gussaðri
gustana	gustanna
gusttu	gutu
gusttuð	gutuð
gustug	gustuk
gustugt	gugti
gusugu	gusuðu
gusupu	gusuðu
guttaðs	gugtaðs
guttla	gutla
guttó	gettó
guttuð	gutuð
guttur	guttar
gutur	getur
guv	guð
guy	gey
guþný	Guðný
gvadelúpeyjar	Gvadalúpeyjar
gvandur	gandur
gvanþróað	vanþróað
gvás	glás
gvengur	gengur
gvenntum	glenntum
gverfa	hverfa
gverið	verið
gvés	vés
gvisu	gistu
gvuðjón	Guðjón
gvýs	gýs;gys
gyda	gyða
gyðue	gyðu
gygt	gigt
gyk	ryk
gyl	gil
gylfannað	gylfanna
gylfannara	gylfanna
gylfannas	gylfanna
gylfannast	gylfanna
gylhjast	giljast
gyljan	kyljan
gyllaap	gylla
gylnnti	grynnti
gylnti	gyllti
gyma	geyma
gymbri	gymbrin
gympri	ympri
gyms	glyms
gymti	gyti
gyn	gin;kyn
gýn	gin;gín;sýn
gynna	ginna
gyntaði	pyntaði
gyptin	Egyptinn
gýr	kýr;gýs
gyrðasta	gyrða
gyrðasts	gyrðast
gyrðastu	gyrðistu
gyrður	gyrðir;Gyrðir;Gerður
gyrn	gin
gysinn	gisinn
gysnar	gisnar
gyssi	gysi
gystar	geystar
gytnaði	getnaði
gyxum	yxum
gyýs	gýs
gzmla	gamla
háðin	háðir;hæðin
hæd	hæð
hæđ	hæð
hæta	gæta;hætta
hafað	hafið;haft
hafn	hrafn;hafna;jafn
hafnafjörður	Hafnarfjörður
hafþór	Hafþór
hagalín	Hagalín
hakon	Hákon
hákon	Hákon
haldreypi	haldreipi
halldór	Halldór
hállt	hált
halsi	haldi
hamborgarahryggur	hamborgarhryggur
hamburgari	hamborgari
hand	handa;hann;hönd
handakriki	handarkriki
handklæð	handklæði
handskar	hanskar
handski	hanski
handur	hendur
hanns	hans
har	hár
harð	harður
harðarsson	harðarson
harna	harðna
háskola	háskóla
háskoli	háskóli
hat	haft;gat;fat;at
hát	hátt
hátið	hátíð
háur	hár
hava	hafa
havær	hávær
havaxinn	hávaxinn
he	hef
hei	hey
heiðann	heiðan
heiðskýr	heiðskír
heiðskýrt	heiðskírt
heilrennt	heilrent
heilur	keilur
heimalingur	heimalningur
heimildarskrá	heimildaskrá
heimir	Heimir
heimsók	heimsókn
heimsokn	heimsókn
heira	heyra
heitann	heitan
hél	hel;él;gel
helð	held
heldr	heldur
hello	hellu;helli
henar	hennar
hengur	lengur;hangir
henntar	hentar
hepinn	heppinn
herbegi	herbergi
herna	hérna
herr	her;hér;herra
hestr	hestur
hestu	helstu;hestur
hetur	heitur;betur;metur;hnetur;hertur
heyrnatæki	heyrnartæki
heyrnatól	heyrnartól
himminn	himinn
hininn	himinn
hinseginn	hinsegin
hír	hýr;hór
hirn	horn;hyrna
his	hins
hisja	hysja
hisst	misst;hist
hit	hitt
hittst	hist;hittust
hjæja	hlæja
hjalp	hjálp
hjalpa	hjálpa
hjálpa	hjálpa
hjart	hjarta;hart
hjlómsveit	hljómsveit
hjol	hjól
hjola	hjóla
hjolið	hjólið
hjóp	hjó;hljóp
hjörður	fjörður;Hörður
hjúkrunafræðingur	hjúkrunarfræðingur
hlada	hlaða
hlæga	hlæja;hlægja
hlápa	klápa;glápa
hlaukinn	hlaupinn;laukinn
hleigið	hlegið
hleitum	heitum
hlekur	hlekkur
hlinur	hlynur;linur
hlipurlega	lipurlega
hlíting	hlíti
hljóðrið	hljóðið
hlöbbum	höbbum
hlýfa	hlífa
hlyntur	hlynntur
hlýtar	hlítar;hlýtur
hlýting	hlýti
hlytt	hlýtt
hlytur	hlýtur
hnef	hnefi
hneiga	hneigja
hneygja	hneigja
hnif	hníf
hnifur	hnífur
hníta	hnýta
hnonna	Nonna
höfa	hafa;höfða
hófsós	Hofsós
höfu	höfuð
höfundaréttur	höfundarréttur
hófý	Hófí
hog	og
högva	höggva
hópavinna	hópvinna
hopur	hópur
horð	hörð
hörður	Hörður
hormónar	hormón
horva	horfa
hosta	hósta;kosta
hotel	hótel
hotelið	hótelið
hótell	hótel
hottur	pottur
hrædur	hræddur
hrann	hann;rann
hrápum	hráum;rápum
href	hreif
hrefurinn	refurinn
hrekkjarvaka	hrekkjavaka
hripurlega	hraparlega
hrisgrjón	hrísgrjón
hrjóðrið	rjóðrið
hróðmar	Hróðmar
hrön	hrönn
hrut	hrút;hlut
hryggjarsúla	hryggsúla
hryna	hrynja;hrina
hrýna	hrína
hrynda	hrinda
hryngja	hringja
hryt	hrýt
hu	hug
hú	hún
húa	húfa
huð	húð;hurð
hufa	húfa
hufu	húfu
huggði	hugði
hugs	hugsa
hum	húm
hummus	húmmus
hun	hún
hundsun	hundsum
húnfjörð	Húnafjörð
hunn	húnn;hún
hunsun	hunsum
húnvettningur	Húnvetningur
hurd	hurð
hurđ	hurð
húrð	hurð;húð
hus	hús
hús	hús
husi	húsi
husið	húsið
hux	hugsa;hús
hva	hvað
hvad	hvað
hvalfirđi	Hvalfirði
hvárt	hvort
hvarta	kvarta
hvat	hvar
hverji	hveri;hverjir
hverr	hver
hvila	hvíla;heila
hvílikur	hvílíkur
hvit	hvít;vit
hvítr	hvítur
hvitt	hvítt;hitt
hvittur	kvittur
hvíttur	hvítur
hvítun	hvítum;hvíttuð
hvitur	hvítur;hvetur
hvítut	hvítur
hvívetni	hvívetna
hyð	hið
hýf	híf
hýfa	hífa
hýfi	hífi
hyggðust	hygðust
hýma	híma
hyrða	hirða
hyrslur	hirslur
hýt	hít
ía	í;ýja
iæra	læra
ibuð	íbúð
ibúð	íbúð
íbuð	íbúð
íbuðin	íbúðin
iðkunn	iðkun;Iðunn
íðu	síðu;íð
iðun	Iðunn
íf	líf
ig	og
íg	í;og
igló	gló;Eygló
íj	í
íja	ýja
ik	il;ok
íkja	ríkja;líkja;kíkja;fíkja
ila	illa
ili	il;illi;gili;bili;
ílla	illa
ilmu	ilmur;Ilmur;filmu
iln	inn;ilm;lin
ilva	Ylva
imynda	ímynda
in	inn
ín	í
ingibjörg	Ingibjörg
ingolfur	Ingólfur
ingun	Ingunn
ingur	ungur;Ingunn
innanhús	innanhúss
innann	innan
innbyrgða	innbyrða
innbyrgðis	innbyrðis
innheldur	inniheldur
ins	eins
ir	úr
iris	íris
ìris	Íris
is	ís
isak	Ísak
ísak	Ísak
ísarr	Ísarr
iseult	Ísold
ískáp	ísskáp
ískápur	ísskápur
island	Ísland
íslandingur	Íslendingur
íslands	Íslands
íslandsk	íslenskt
íslending	Íslending
íslendingar	Íslendingar
islendingur	Íslendingur
íslenk	íslensk
íslenkur	íslenskur
islensk	íslensk
islenska	íslenska
islenskt	íslenskt
islensku	íslensku
islenskur	íslenskur
isskápur	ísskápur
it	ið
ít	í;út
íta	ýta
italia	Ítalía
ítalia	Ítalía
ítalsk	ítalskt
italska	ítalska
íx	óx
íþrott	íþrótt
íþrottir	íþróttir
ja	já
jað	að
jakob	Jakob
jam	jarm
januar	janúar
japansk	japanskt;japönsk
japansku	japönsku
jar	kar;jarl
jár	járn
járbrautarlest	járnbrautarlest
járbrautarlestin	járnbrautarlestin
jarð	varð;jörð
jarðaber	jarðarber
jarðaför	jarðarför
jarn	barn;jarm
jasmin	jasmín;Jasmín
jeg	ég
jenny	Jenný
jesú	Jesús
jesus	Jesús
jet	get;fet
jí	í
jo	jó
jógurt	jógúrt
jol	jól
jólatrésala	jólatréssala
jon	Jón
jonas	Jónas
jord	jörð
jorð	borð;morð;hirð
jörd	jörð
jörmun	Jörmund
jórun	Jórunn
jóx	óx
ju	jú
jugga	jukka
julia	Júlía
júni	júní
júr	júgur;úr;ýr
jux	óx
kacper	kasper
kærastin	kærastinn
kæresti	kærasti
kaffibollin	kaffibollinn
kaffihus	kaffihús
kagl	kall;karl
kajus	kaus
kald	kalda;vald;köld
kalfur	kálfur
kalkunn	kalkúnn
kálkunn	kalkúnn
kallt	kalt
kaltur	kaldur;haltur
kama	karma;kamar
kán	lán;skán
kanina	kanína;kanna
kannari	kennari
kanntur	kantur
kanpi	kanti
kanski	kannski
kap	kaup
kapa	kápa;kaupa
kapur	kápur
karolina	Karólína
karrý	karrí
kartefla	kartafla
kartöfl	kartöflu
kartofla	kartafla
kartöfla	kartafla
kartoflum	kartöflum
kartóflumús	kartöflumús
kartoflur	kartöflur
katharina	Katarína
katrin	Katrín
kattur	skattur
kax	lax;kex
kayak	kajak
kaypa	kaupa
keflavik	Keflavík
keira	keyra
kel	gel
kema	kemba;þema
kenitala	kennitala
kennar	kennari;kenna
két	kjöt
ki	kí
kikja	kíkja
kikkja	skikkja;kíkja
kílo	kíló
kílometri	kílómetri
kin	kyn
kina	Kína
kinkja	kyngja
kír	kýr
kírkja	kirkja
kísa	kisa;Kína;krísa
kiss	koss;kyssa
kissa	missa;kyssa
kíssa	kyssa
kissi	kyssi
kít	kýt
kíta	kýta;líta
kíti	kýti
kítl	kitl
kítla	kitla
kiwi	kíví
kjáa	kjá
kjallar	kjallari;kallar
kjartann	Kjartan
kjet	kjöt
kjoll	kjóll;koll
kjosa	kjósa
kjot	kjöt
kjót	skjót;kjöt
kjukling	kjúkling
kjuklingur	kjúklingur
kjurr	kyrr
kjurrt	kyrrt
kk	kúk
klá	klám;klár
klæda	klæða
klæđa	klæða
klarinett	klarínett
klínik	klíník
klíník	klínísk
kloset	klósett
klóset	klósett
klosett	klósett
klosset	klósett
klrkja	kirkja
klukkutima	klukkutíma
knega	knefa
knér	kneri
knoa	kona
knú	kný
koda	kodda;kóða
koddan	koddann
kóma	koma
kommoda	kommóða
kommoða	kommóða
koms	koma
konguló	kónguló
kongur	kóngur
kóngurló	kónguló
konungr	konungur
kopavogur	Kópavogur
kopur	kópur;konur;koppur
kostning	kosning
kósý	kósí
köt	kjöt
kottur	köttur;kostur
kóttur	köttur
kötur	götur;köttur
kox	kex
krakkur	krakkar
kreðsa	kreða
kreptan	krepptan
kreysta	kreista
krikja	kirkja
krístin	Kristín;kristin
krístín	Kristín;kristin
krókódill	krókódíll
krona	króna
kronan	krónan
kronur	krónur;konur
krump	krumpa
krumpla	krumpa
ku	kú
kuð	guð
kuf	kúf
kum	um;kyn;kom
kun	kyn
kuna	kunna
kunning	kynning
kur	kúr
kúrbitur	kúrbítur
kus	kusu
kutter	kútter
kuttur	köttur
kvá	hvá
kvedja	kveðja
kveđja	kveðja
kvefa	kvefað
kvekja	kveikja;hvekkja;vekja
kvekt	kveikt;hvekkt
kvektur	hvekktur
kvennmaður	kvenmaður
kvennmenn	kvenmenn
kvetja	hvetja
kviðin	kviðinn;kvíðin
kvíður	kviður;kvíðir;kveður
kvíkmynd	kvikmynd
kvila	kvilla;hvíla
kvitun	kvittun
kvívetna	hvívetna
kvold	kvöld
kvölð	kvöld
ký	kýr;kú
kyð	kið
kym	kyn
kyngimagnað	kynngimagnað
kyngimagnaður	kynngimagnaður
kynseigin	kynsegin
kys	kyns
kysa	kyssa
kýsi	kysi
lað	að;það
læara	læra
laera	læra
læta	læt;læti
lágr	lágur;lágu;lágir;lágt
lakkris	lakkrís
lamp	lampi
lan	land;lán
lángur	langur
laser	leysir
latensk	latnesk
látta	láta
laugardagurkvöld	laugardagskvöld
lausann	lausan
lausur	laus;lausu
lávaxinn	lágvaxinn
laxness	Laxnes
le	leið
lea	Lea
lég	ég
leggji	leggi
legja	leggja;leigja
legst	leggst
leigandi	leigjandi
leikhus	leikhús
leisa	leysa
leo	leó;Leó
leò	leó;Leó
lesandur	lesendur;lesandi
leta	leita;feta;létta
lett	létt;lest
leypur	hleypur
leyta	leita
lí	í
liðan	líðan
lífandi	lifandi
lifsmörk	lífsmörk
lífstill	lífsstíll
lifta	lyfta;lista
lig	liggur
ligga	liggja
liggji	liggi
ligja	liggja
ligur	liggur
lik	leik;lík
lika	líka
líkam	líkami
likami	líkami
líkamin	líkaminn
líkams	líkama
likan	líkan
likar	líkar
likill	lykill
likt	líkt;lykt
lily	Lilý
liod	ljóð;ljót
lioð	ljóð;lið
liód	lið;ljóð
lióð	ljóð;lið;lóð
liöð	lið;ljóð
lís	lús
lisa	losa;Lísa
lísta	lista;lýsti
lísti	lýsti
lístur	lýstur
lítast	líta;litast
lítháen	Litháen
litháenska	litháíska
litil	lítil
litíl	lítil
litill	lítill
litíll	lítill
lítin	lítinn
litl	litla
lítl	lítil
lítla	litla;líta
lítli	litli
litll	litli
lítll	lítill
lítlum	litlum
littil	lítil
líttil	lítill
ljó	ljós
ljoð	ljóð
ljos	ljós
ljosakrona	ljósakróna
ljósrofi	ljósarofi
ljot	ljót
ljóttur	ljótur
ljúa	ljúga
ljuga	ljúga
ljuka	ljúka
logan	logann
lógu	lágu;lóga
lýf	lyf;líf
lyfa	lyf;lifa
lyggja	liggja
lýgi	lygi
lýkill	lykill
lýkt	líkt
lysa	lýsa
ma	má
máa	má
mað	máð;maður;með;að
maðir	maður
maðr	maður
madur	maður;matur
mađur	maður
maðurin	maðurinn
mađurinn	maðurinn
maðut	maður
magnus	Magnús
mai	maí
mais	maís
mallýsku	mállýsku
máltið	máltíð
mama	mamma
mán	máni
mánað	mánaða
mánaði	mánuði
mánaður	mánaðar
maneskja	manneskja
mannafl	mannafla
mannst	manst
mannstu	minnstu;manstu
mánu	máni
mánuðar	mánaðar
mánudi	mánuði
manuður	mánuður
mánudur	mánuður
mánuđur	mánuður
mánúður	mánuður
manuel	Manúel
mapur	maður
màr	már
marðan	marða
marg	margt;margur;mark
margfallt	margfalt
margi	margir
maria	María
markaðsetja	markaðssetja
máson	másson
matarlist	matarlyst
matin	matinn
matthias	Matthías
mattin	máttinn
mature	matur
maukur	mauk
maya	maka;mata;maga
me	með;mér
méð	með
meðhandla	meðhöndla
megja	meyja;mega
megu	megum
meida	meiða
meiga	mega
meigi	megi
meigum	megum
mentun	menntun
mentunn	menntun
meò	með
mep	með
mes	nes
mexikó	Mexíkó
mi	mig
mí	mý
míða	miða;víða;smíða
midbær	miðbær
míði	miði;líði;smíði
miðnæti	miðnætti
miðvikidaginn	miðvikudaginn
míkið	mikið
míkil	mikil
míkill	mikill
mikin	mikinn
míkinn	mikinn
mikit	mikið
millý	milli
min	mín;mun;mitt
mina	mína;minna
minar	mínar
mind	mynd
minir	minnir;mínir
minkunn	minnkun
mínn	minn;mín
minnkunn	minnkun
mins	míns
minsta	minnsta
minu	mínu
minum	mínum
minus	mínus
mínút	mínútu
minuta	mínúta
minúta	mínúta
mínuta	mínúta
minutur	mínútur
mínutur	mínútur
míó	bíó
mís	maís;mús
miskun	miskunn
míta	mýta
mítt	mitt
mjóastur	mjóstur
mjök	mjög
mjolk	mjólk
mjölk	mjólk
mjuk	mjúk
mjukt	mjúkt
mjukur	mjúkur
mo	má
moður	móður;maður
möður	mörður
mólk	mjólk
molly	molli
morg	mörg
morgnin	morgni
morgu	morgun
morgunfull	morgunfúll
morgunin	morguninn
morgunnin	morguninn
mös	nös
mota	motta;nota
mótakka	móttaka
motus	moturs
mu	um
mú	nú;mý
múkt	mjúkt
mún	hún;mín
munnt	munt
muns	munns;muna;mun
murkur	myrkur
mus	mús;mis
músir	mýs
músli	múslí
múslim	múslimi
my	mý
mýga	míga
myn	minn;mynt;mun
mynð	mynd
mýnd	mynd
myndalegur	myndarlegur
mynnast	minnast
mys	mýs;mysa
mýsa	mysa
mýt	mýta;nýt
nà	ná
nafur	næfur
nág	nóg
nagl	nagli
nágrani	nágranni
nágrannur	nágrannar;tágrannur;tággrannur
nágreni	nágrenni
náll	Njáll;nál
námsfús	námfús
namskeið	námskeið
námsskeið	námskeið
náttur	máttur
náttura	náttúra
nátura	náttúra
nátúra	náttúra
nauðu	nauðum
ne	nei;né;en
nefndr	nefndur
nefninlega	nefnilega
neið	neyð
nemand	nemandi
nemandur	nemendur
nemendi	nemandi
nemu	nema
nér	mér;neri
nés	nes
netur	getur;nettur;hnetur
new	nei
nex	vex
ney	nei
neys	neysla
nf	af
ni	nú;ný
ní	ný;í
níður	niður;níð
niðurstað	niðurstaða
nís	nýs
nita	nit
níta	nota;nýta
niti	nit
nítíu	níutíu
njota	njóta
no	nóg
nóel	Noel
nog	nóg
nokkir	nokkrir
nokkri	nokkrir
nokkrur	nokkrir;nokkur
nökkur	nokkur
nökkurs	nokkurs
nökkut	nokkurt
nokra	nokkra
norænn	norrænn
norð	morð;norður
nöt	nötur;not
notarlegt	notalegt
notarlegur	notalegur
notkunn	notkun
nott	nótt;gott
nött	nótt
nóttuni	nóttunni
november	nóvember
nu	nú
nuð	náð
núð	húð;snúð
nuðlur	núðlur
num	um;mun;nam
numer	númer
núr	múr;búr
nútið	nútíð
ny	ný;nú
nýa	nýja
nýan	nýjan
nýar	nýjar
nyð	nið;niður
nýð	níð
nýða	níða
nyður	niður
nýj	ný
nyja	nýja
nýjann	nýjan
nýji	nýi
nýjir	nýir
nýjur	nýju;níur
nýpur	nípur;núpur
nyr	nýr;nær
nýrr	nýr
nýskur	nískur
nysta	nyrsta;nísta
nýstálegum	nýstárlegum
nytt	nýtt;nótt
nýung	nýjung
oð	óð
öd	öld
öð	að
öðla	söðla;öðlast
ǫðrum	öðrum
öðruvísa	öðruvísi
öðruvisi	öðruvísi
ódyr	ódýr
ódyrt	ódýrt
öf	af
ofundar	öfundar
ög	og
oh	ó
ök	ók;tök;sök
oktober	október
óktóber	október
öku	óku
ol	ól;öl
olafur	ólafur
ólett	ólétt
ólia	olía
ólifur	ólífur
ólikur	ólíkur
olla	Olla
öllsömun	öllsömul
olöf	ólöf
óls	Óla;ól
om	óm
öm	óm;söm
omega	ómega
on	son
ön	önn
öndur	öndun
öngvu	öngvum
önur	önnur
ór	kór;sór;mór;fór
orðaforð	orðaforði
orðstýr	orðstír
orðtak]	orðtak
örðuleikar	örðugleikar
örðuleiki	örðugleiki
ork	orka;rok
orkupakkanns	orkupakkans
örrug	örugg
örruggur	öruggur
örrugur	öruggur
öruglega	örugglega
öryggur	öruggur
os	ós;oss;og
ösa	ausa
osk	ósk
ösk	ósk
oska	óska
ot	ota;pot
ótrulega	ótrúlega
ox	óx
öxa	öxi
óxi	öxi;óx;uxi
óxu	óx;uxu
óþæginlegt	óþægilegt
óþæginlegur	óþægilegur
pað	það
pær	þær;lær
paka	baka;pakka
paki	pakki;þaki
pan	plan
panni	þannig;penni
papir	pappír
papír	pappír
papríka	paprika
papúískur	papúskur
parf	þarf
paris	París
partin	partinn
party	partí
pau	þau
paurað	párað;paur
peir	þeir
peningaþvottur	peningaþvætti
pennan	pennann
pennin	penninn
penning	pening
penninga	peninga
penningar	peningar
penningur	peningur
pepperoni	pepperóní
persón	persóna
persona	persóna
pérsona	persóna
personur	persónur
pessa	pressa;passa
pessi	þessi
pesti	festi;vesti;besti;mesti
petur	pétur;Pétur
peys	peysu
pi	pí
piano	píanó
píano	píanó
pinn	pinni;þinn
pisa	pissa;písa
pita	píta
pittur	pyttur
plagat	plaggat;plakat
plant	planta
póka	poka;bóka
póki	poki;púki
pokka	poka
poland	Pólland
póland	Pólland
polska	pólska
portugal	Portúgal
post	póst
postur	póstur;kostur
posturinn	pósturinn
prífa	þrífa
prír	þrír
prjona	prjóna
prof	próf
profa	prófa
prófarkalesa	prófarkalestur
prófataka	próftaka
prófil	prófíl
prófill	prófíll
prosent	prósent
puls	púls;plús
púnktur	punktur
purfa	þurfa
pvo	svo;þvo
pý	pí
pyls	pylsa
pýna	pína
ra	ára
rabbarbari	rabarbari
rað	ráð;röð;að
ráda	ráða
ræda	ræða
ræri	reri
rætina	ræktina
rætistu	rætist
rafnsungar	hrafnsungar
ragnarr	ragnar;Ragnar
rakk	rakki
rakkl	rakki
ran	rán
rannsakna	rannsaka
rannsók	rannsókn
ransókn	rannsókn
rassin	rassinn
rasskin	rasskinn
ratt	hratt
raud	rauð
rauđ	rauð
raudur	rauður
rauđur	rauður
rauðvin	rauðvín
raunið	hraunið;raunin
raut	hraut;braut;graut
rax	sax
re	er
reð	réð
reða	eða
rég	ég
regnhlif	regnhlíf
regnvötn	regnvatn
reiðrinu	hreiðrinu
rén	réna
rer	reri
rér	rýr;reri
rét	rétt
réttann	réttan
rey	reyk
reyka	reyna;reykja
reykingarmaður	reykingamaður
reykingmaður	reykingamaður
reykjavik	Reykjavík
reykningur	reikningur
reys	reis
reysa	reisa
ría	rýja
rifast	rífast
rik	ryk;rík
riki	ríki
rikisstjorn	ríkisstjórn
rikl	rikli
rikur	ríkur;vikur
ringdi	rigndi
rír	rýr;þrír
rísastór	risastór
rísta	rista
rix	ris
ro	ró
roa	rosa;róa
rók	tók;rok
róland	rólandi
rolegur	rólegur
rópuðu	hrópuðu;rápuðu;ropuðu
ros	rosa;rós;ross
rös	gös
rósalega	rosalega
rósinkál	rósakál
röt	rör;föt
ru	eru
rúa	búa
rúmstökk	rúmstokk
run	Rún;mun;raun
rus	ris
rússibani	rússíbani
russland	Rússland
ruta	rúta;rúnta
rúturinn	rúnturinn;hrúturinn
rýa	rýja
rýfa	rífa
rýg	rýr;rígur;ríg
rys	ris
rýtur	rútur;hrýtur
sa	sá;sé
sà	sá
sað	sáð
sadd	södd
sæka	sækja
sæu	sæju
sagdi	sagði
sagg	sag;saggi
sagja	segja
sagn	sagt;sagan;sögn
sak	saka
sakn	sakna
sam	sami
samála	sammála
samfelag	samfélag
samhryggja	samhyggja
samloko	samloku
samlöku	samloku
sammâla	sammála
sammþykkja	samþykkja
samói	Samóa
samu	sömu;sámur
samþyggja	samþykkja
samþyki	samþykki
samþykja	samþykkja
sán	sána
sandal	sanddal;Sanddal;sandali
sannalega	sannanlega;sannarlega
sannleikan	sannleikann
sauðakrókur	Sauðárkrókur
sauðarkrókur	Sauðárkrókur
sauna	sána
se	sé
sebastian	Sebastían
sebastían	Sebastían
seða	seðja
ség	ég
segia	segja;segir;seiga
segji	segi
seiðingur	seyðingur
seinkunn	seinkun
seja	segja
sekunda	sekúnda
sekúnta	sekúnda
sél	sel
sendann	sendan
ser	sér;er;sem
séri	sér
sérst	sést
sérstak	sérstakt
sérstaklegur	sérstakur
setningur	setningu
settja	setja
settning	setning
seyja	segja;deyja
seylast	seilast
seylist	seilist
si	sé
siðari	síðari
sidast	síðast
siðasta	síðasta
siðasti	síðasti
siðastur	síðastur
siðustu	síðustu
síðustur	síðastur
síf	Sif;svíf
sígarett	sígarettu
sigaretta	sígaretta
sígarettapakki	sígarettupakki
sígarettpakki	sígarettupakki
sigja	segja;sía;sýja;síga
sígja	síga
sigriður	Sigríður
sígriður	Sigríður
sigrun	Sigrún
sígurður	Sigurður
síja	sía
sikur	sykur
silvur	silfur
símanumer	símanúmer
símin	síminn
símmi	sími
simon	Símon
sind	synd
singa	syngja
singja	syngja
sini	sinni;syni
sínn	sín;sinn
sistir	systir
sistkyn	systkin
sistkyni	systkini
sistur	systur;situr
sita	sitja
sitjast	setjast
sitrona	sítróna
sitróna	sítróna
sítrona	sítróna
sitta	sitt;sitja
sittja	sitja
siv	sif;Sif;sig
sja	sjá
sjà	sjá
sjáland	Sjáland
sjálfann	sjálfan
sjóari{k}]	sjóari
sjoða	sjóða
sjonvarp	sjónvarp
sjöti	sjötti
sjóvarp	sjónvarp
sjúkdom	sjúkdóm
sk	ask
skald	skal;skáld
skamm	skammt;skamma
skammarbréf	skammabréf
skamt	skammt
skannari	skanni
skapur	skápur
skarpheðinn	Skarphéðinn
skársta	skásta
skárstur	skástur
ské	ske
skemmtur	skemmtir;skammtur
skemtileg	skemmtileg
skemtilega	skemmtilega
skemtilegt	skemmtilegt
skemtilegur	skemmtilegur
skemtun	skemmtun
skemtuninni	skemmtuninni
skí	skín;ský
skiði	skíði
skifta	skipta
skifti	skipti
skíl	skýli
skilabóð	skilaboð
skill	skil
skilmál	skilmála
skilt	skylt;skilti
skípi	skipi;skrípi;skíði
skipulegja	skipuleggja
skírleiksstúlka	skýrleiksstúlka
skirta	skyrta
skirteini	skírteini
skitugur	skítugur
skjál	skjálf;skál;skjal
skjalfa	skjálfa
skjavarpi	skjávarpi
skjota	skjóta
skoda	skoða
skođa	skoða
skóðanir	skoðanir
skóðun	skoðun
skogur	skógur
skól	skóla;skóli;skal
skolan	skola;skólann
skólan	skólann
skolann	skólann
skolanum	skólanum
skolí	skóli
skólí	skóli
skólin	skólinn
skolinn	skólinn
skòlinn	skólinn
skóp	skólp
skótland	Skotland
skrífa	skrifa
skriffinska	skriffinnska
skritið	skrítið;slitið
skritin	skrítin
skritinn	skrítinn
skriva	skrifa
skrýmsli	skrímsli
skryn	skyn;skrun
sku	sko
skú	ský
skuffa	skúffa
skul	skal
skula	skila;skulu
skulla	sulla;skalla
skura	skúra
skutl	skutla
sky	ský
skygnast	skyggnast
skylirði	skilyrði
skylst	skilst
skýna	skína;sýna
skyrsla	skýrsla
skyrt	skýrt
skýrteini	skírteini
slepa	sleppa
sleypt	sleipt
slí	slý
slokkva	slökkva
slökva	slökkva
smatt	smátt
smegja	smeygja
smeigja	smeygja
smeikur	smeykur
smeyja	smeygja
smiđur	smiður
smíður	smiður;smíðar
smjór	smjör
smur	smurt
snellið	smellið
snemmur	snemma
sníðugur	sniðugur
sníta	snýta
snjor	snjór
snór	snjór
snua	snúa
so	sé
só	sé
sóf	sór
sófan	sófann
sofanum	sófanum
sofí	sófi
sofia	Sofía
sófin	sofin;sófinn
sók	sól;sök
sókkar	sokkar
sókkur	sokkur
sökva	sökkva
sol	sól
soley	Sóley
sólsetuna	stólsetuna
sólveig	Sólveig
sömul	sömu
söngkuno	söngkonu
söngstjór	söngstjóri
sonir	sonur
sonnur	sonur
sónur	sonur
sor	sór;sori
sör	sér
sova	sofa
spent	spennt
spentur	spenntur
spirja	spyrja
spítal	spítala
spitala	spítala
spitali	spítali
splunkunyr	splunkunýr
spreita	spreyta
spur	spyr
spurnig	spurning
spurningarlisti	spurningalisti
spurningur	spurningar
spurtning	spurning
spyra	spyrja
spýrja	spyrja
spyrr	spyr
stætó	strætó
stafsetningavilla	stafsetningarvilla
stakkt	stakt
stákur	strákur
stár	sár;stór;tár
starfsman	starfsmann
stasi	stansi
stefan	Stefán
steipireiður	steypireyður
stelp	stelpa
stelpar	stelpur
stemdur	stemmdur
stenda	standa;senda
steypireiður	steypireyður
steypreiður	steypireyður
stí	stíl
stiðja	styðja
stiflað	stíflað
stiflaður	stíflaður
stigvel	stígvél
stigvél	stígvél
stígvel	stígvél
stíja	stía
stiltur	stilltur;stultur
stíra	stýra
stittist	styttist
stixa	stiga
stja	stjá
stjarn	stjarna
stjori	stjóri
stjörn	stjörnu;stjórn;stjarna
stjórnvölin	stjórnvölinn
stockholm	Stokkhólm
stöðuleiki	stöðugleiki
stófa	stofa
stöfu	stofu
stòla	stóla
stoll	stóll;stol;stolt
stöll	stöllum
stóllin	stólinn;stóllinn
stollt	stolt
stolltur	stoltur
stopa	stoppa
stor	stór
stòr	stór
stora	stóra
storan	stóran
stórann	stóran
stórr	stór
stort	stórt
stórur	stór;stórir;stórar
stræto	strætó
strak	strák
strakur	strákur
stràkur	strákur
straukur	strauk;straumur;strákur
strengri	strangari
strið	stríð
striða	stríða
strond	strönd
stúdenstpróf	stúdentspróf
studningur	stuðningur
stulka	stúlka
stundur	stund;sundur
sturt	sturta
stutur	stuttur;stútur
stynga	stinga
styrnir	Styrmir
su	sú;sé
súkkulað	súkkulaði
sukkulaði	súkkulaði
súkkulađi	súkkulaði
súkkulaðiðkaka	súkkulaðikaka
súkkulaðiðkakan	súkkulaðikakan
suld	súld
sun	sund;sin;syn
supa	súpa;suma
sur	súr
svá	svo
svár	sár
svatur	svartur
svef	svefn;sveif;
svefnburka	svefnpurka
svefnpurrka	svefnpurka
sveiplur	sveiflur
sveitarbær	sveitabær
sveitur	sveittur;sveitir
sví	svo
svíðjóð	Svíþjóð
svípaður	svipaður
svó	svo
svolitið	svolítið
sýa	sía;sýna
syg	sig
sygin	sigin;sigyn
sýkur	sykur
syna	sýna;sína
syndja	synda
synga	syngja
syning	sýning
syningarnar	sýningarnar
sýningur	sýningu
sýróp	síróp
syskini	systkini
sýstir	systir
systkinni	systkini
systkyn	systkin
systkyni	systkini
systkynni	systkini
sýstur	systur
syt	sit
ta	tá
talfa	tölva
tálnum	táknum
tán	tá
tann	tanni;hann;tönn
tar	tár
táraðu	tóra
tas	fas
task	taska
tata	fata
tauf	rauf
tébolla	tebolla
tegja	teygja
tekr	tekur
tengls	tengsl
tér	sér;þér
text	texti;tekst
textan	textann
textur	texti
teygji	teygi
teyja	teygja
ti	til
tið	tíð
tik	tík
tíl	til
tílbúinn	tilbúinn
tilfining	tilfinning
tilhlíðlegt	tilhlýðilegt
till	til
tilvík	tilvik
tima	tíma
tíme	tíma
timi	tími
timinn	tíminn
tíml	tími
tít	títt
títill	titill;lítill;trítill
tix	til
tjáningafrelsi	tjáningarfrelsi
tjekka	tékka
tjilla	tilla
to	tó
tö	tvö
tóf	töf
tolva	tölva
tolvan	tölvan
tölvs	tölva
tölvupost	tölvupóst
tölvupostur	tölvupóstur
tomat	tómat
tomata	tómata
tomatar	tómatar
tomatur	tómatur
tomur	tommur;tómur
tön	tönn
tonleikar	tónleikar
tónleikaк	tónleikar
tonlist	tónlist
tónlistamaður	tónlistarmaður
trað	trúað
tre	tré;the
tromm	tromma
trua	trúa
trúarbragð	trúarbrögð
trump	Trump
trunt	trunta
tu	tíu;trú;þú
tum	um
tun	tún
tung	þung
tungamál	tungumál
tungumal	tungumál
túngumál	tungumál
tunn	tunna
tur	túr
túrist	túristi
tvei	tveir
tvem	tveim
tviburi	tvíburi
tvísvar	tvisvar
tvó	tvö
týa	tía
týð	tíð
týma	tíma
tými	tími
tyna	týna;tína
ubbur	nubbur;Unnur;stubbur
ud	út
uð	að;suð
ufundar	öfundar
ug	út;hug
úg	út
uk	um;yl
uku	juku;óku
ul	ull;yl;il
ulfr	úlfur
ulfur	úlfur
ulpa	úlpa
umbra	lumbra
umbuðir	umbúðir
umhyggjur	umhyggju
umir	sumir
ummönnun	umönnun
ummönun	umönnun
umsækendur	umsækjendur
umsjónakennari	umsjónarkennari
umsokn	umsókn
ún	hún
unar	unnar
undanskyldu	undanskildu
undirbua	undirbúa
ungmenn	ungmenni
unt	unnt;munt;punt
up	upp
uppahalds	uppáhalds
uppaladi	uppalandi;uppaldi
uppgvöta	uppgötva
upphýfing	upphífing
upplífa	upplifa
upplifanir	upplifunar
upplysing	upplýsing
upplysingar	upplýsingar
úpplysingar	upplýsingar
úpplýsingar	upplýsingar
upplýsingur	upplýsingar
uppþvottarlögur	uppþvottalögur
uptekinn	upptekinn
ur	úr
us	uss
ús	hús;mús;lús;fús
ut	út
útan	utan
utanhús	utanhúss
útgafa	útgáfa
uti	úti
útskíra	útskýra
útskrist	útskrift
útskyra	útskýra
útsyni	útsýni
útsyning	útsynning
úttek	úttekt
úttekið	útitekið
utvarp	útvarp
ux	uxi
uxið	exið;uxinn
uxna	uxa
va	var
væ	væl;bæ;fæ
vænstr	vænst
væntur	kvæntur;vænt
vág	vá
vand	vanda
vandamal	vandamál
vandill	vindill
vandmál	vandamál
vanliðan	vanlíðan
váru	voru
vás	bás;var;vas
vasan	vasann
vát	bát;fát
ve	vel;vé
vedrið	veðrið
vedur	veður;vefur
vég	ég;veg
vegginum	veggnum
vegsumerki	vegsummerki
veida	veita;veiða
veiđa	veiða
veislun	geislun;veislu
veitingarstað	veitingastað
veitingarstaður	veitingastaður
vekji	veki
velliðan	vellíðan
venir	vinir
verda	verða
verit	verið
verkalíður	verkalýður
verkefnastýra	verkefnastjóri
verq	vera
ves	vesen;vers;vel
vesk	veski
vest	vesti;vestur
vestfjörður	vestfjörðum
veta	vera;veita
vetlinga	vettlinga
vetlingar	vettlingar
vetlingur	vettlingur
vetrafrí	vetrarfrí
vetrinn	veturinn
vetvangur	vettvangur
véx	vex
vexi	vex;vaxi
vi	við
vid	við
viðburðarríkur	viðburðaríkur
video	vídeó
videó	vídeó
vídeo	vídeó
víðfem	víðfeðm
víðfemt	víðfeðmt
víðfemur	víðfeðmur
viðs	viða;við;víða
viðstattur	viðstaddur
vietnam	Víetnam
vigdis	Vigdís
vikingur	víkingur;Víkingur
vikja	víkja
vikt	vigt
víku	viku
vilga	vilja
vilia	villa;vilja
vilija	vilja
villja	vilja
víltu	viltu
viltur	villtur
vinber	vínber
vinður	vinur;vindur
vínir	vinir
vínkona	vinkona
vinkour	vinkonur
vinnkona	vinkona
vinnuni	vinnunni
vinnunna	vinnuna
vínnur	vinnur
vínur	vinur
virðingafyllst	virðingarfyllst
vis	viss;við
visbending	vísbending
visindi	vísindi
viua	vita
vo	svo;vó
vö	tvö;vó
vóð	óð
vontur	vondur
vór	vor;bór
vorkun	vorkunn
vös	nös;vör
ýa	ýja
yasmine	Jasmín
yð	ið;iða;að
ýð	að
yða	iða
ydar	yðar
ýfað	ýjað
yfirsjá	yfirsýn
yftu	ypptu
ylm	ilm
ým	mý
ymsir	ýmsir
ýmsur	ýmsir
ýn	en
yndæll	indæll
ynna	kynna;inna
yra	yrja
yri	yrki
yrr	fyrr;Ýrr
yrta	ytra
yrtur	yrtu
ysa	ýsa
yt	ýta;út;nyt
yta	ýta
ýtreka	ítreka
yx	uxi;vex
yxa	yxna;uxa
þa	þá;það
þađ	það
þæginlegt	þægilegt
þap	það
þarlendis	þarlends
þás	þá
þat	það
þátið	þátíð
þáttaka	þátttaka
þáttakandi	þátttakandi
þáttakendur	þátttakendur
þattur	þáttur
þaug	þau
þauta	þaut
þé	þér
þei	þeir
þeirr	þeirra
þeita	þeyta
þemi	þeim
þena	þéna
þenan	þennan
þenann	þennan
þenna	þennan
þennann	þennan
þennsla	þensla
þer	þér
þetti	þetta
þettta	þetta
þí	þú
þier	þeir
þíg	þig
þik	þig
þikja	þykja
þínn	þinn;þín;þann
þír	þrír
þit	þitt
þít	þýt
þjóðann	þjóðanna
þjódninn	þjónninn
þjonn	þjónn
þjónnin	þjónninn
þól	þol
þöl	þöll
þóla	þola
þólinmóður	þolinmóður
þör	þor
þórarin	þórarinn
þorarinn	Þórarinn
þordís	Þórdís
þórðis	Þóris
þórðís	Þórdís
þórun	Þórunn
þót	þótt
þóu	þó
þrainn	Þráinn
þrautsegja	þrautseigja
þreita	þreyta
þreittur	þreyttur
þrettur	þreyttur
þreyfa	þreifa
þreytur	þreyttur
þreyyt	þreytt
þrí	þrír
þríðja	þriðja
þrir	þrír
þriu	þrír
þríu	þrír
þrjátiu	þrjátíu
þrjir	þrjár
þrjír	þrír
þrjóna	prjóna;þjóna
þrju	þrjú
þrýfa	þrífa
þrymir	þyrmir
þrystingur	þrýstingur
þu	þú
þúmall	þumall
þun	þunn
þungmiðja	þungamiðja
þurf	þurfi
þurka	þurrka
þurkka	þurrka
þurkur	þurrkur
þusund	þúsund
þv	því
þveir	þeir
þvi	því
þvó	þvo;því;þó
þvö	þvo
þyða	þýða
þýda	þýða
þyðir	þýðir
þyðna	þiðna
þygg	þigg
þyggja	þiggja
þygja	þiggja
þyk	þyki
þýkir	þykir
þýn	þín
þyskaland	Þýskaland
