19km 	19 km 
35sm 	35 cm 
Afhverju 	Af hverju 
Alþjóðasundambandið 	Alþjóðasundsambandið 
Angelses 	Angeles 
Atvinnvega- og nýsköpunarráðuneytis 	Atvinnuvega- og nýsköpunarráðuneytis 
Aðal brautryðendur 	Aðalbrautryðjendur 
Aðal fæða 	Aðalfæða 
Aö 	Að 
BBCum 	BBC um 
Babýlóníyumönnum 	Babýlóníumönnum 
Bandaríkjann 	Bandaríkjanna 
Bandaríkjunnum 	Bandaríkjunum 
Bandaríkjunum út 	Bandaríkinút 
Bigir 	Birgir 
Bjötrgunarsveitamenn 	Björgunarsveitarmenn 
Blómaskreytarnir 	Blómaskreytararnir 
Borgaryfrvöldum 	borgaryfirvöldum 
Breiðablk 	Breiðablik 
Breiðaliks 	Breiðabliks 
Byggðastofnunnar 	Byggðastofnunar 
Búlgaria 	Búlgaría 
Danakonunig 	Danakonungi 
Dæmiði  	Dæmið 
Einungsi 	Einungis 
Enarmarkið 	Endamarkmið 
Englisaxar 	Engilsaxar 
Ennfermur 	Enn fremur 
Ennig 	Einnig 
Evópu 	Evrópu 
Eyrasundslestinni 	Eyrarsundslestinni 
Eysti 	Eystri 
Filipseyjum 	Filippseyjum 
Fjölskyla 	Fjölskylda 
Fleirra 	Fleira 
Fleirri 	Fleiri 
Foreldara 	Foreldrar 
Forgripasafnins 	Forngripasafnsins 
Fornleifarannsókninn 	Fornleifarannsóknin 
Forsetin 	Forsetinn 
Forvaraanahóp 	Forvarnarhóp 
Fraklandi 	Frakklandi 
Fundar 	Fund 
Fármálaeftirlitið 	Fjármálaeftirlitið 
Gangsegir 	Gang segir 
Garðarson 	Garðarsson 
Gaðabæ 	Garðabæ 
Gissurason 	Gissurarson 
Guðjbörg 	Guðbjörg 
Han 	Hann 
Handayfirlangningar 	handayfirlagningar 
Heilddarvirði 	Heildarvirði 
Hermannsyni 	Hermannssyni 
Hersöfðinginn 	Hershöfðinginn 
Hilmarssyn 	Hilmarssyni 
Hljómsvetin 	Hljómsveitin 
Honnum 	Honum 
Hæstakauptað 	Hæstakaupstað 
Hæun 	Hún 
Hérmá 	Hér má 
Innann 	Innan 
Innréttingana 	Innréttinganna 
Irak 	Írak 
Islam 	íslam 
Istanbul 	Istanbúl 
Italía 	Ítalía 
Jafnfram 	Jafnframt 
Jan-Mayen-hrygginn 	Jan Mayen-hrygginn 
Jókertöurnar 	Jókertölurnar 
Kalvinista 	kalvínista 
Kapítolið 	Kapítalið 
Karneval 	Karnival 
Kaupingi 	Kaupþingi 
Keppninn 	Keppnin 
Klettadopan 	Klettadoppan 
Krafwerk 	Kraftwerk 
Krikjan 	Kirkjan 
Kóranin 	Kóraninn 
Kóreanska 	kóreska 
Kúvæt 	Kúveit 
Landhelgisgæslunnu 	Landhelgisgæslunni 
Landspítlans 	Landspítalans 
Legstu 	Leggstu 
Lundúnarfélagið 	Lundúnafélagið 
Lýðveldiisflokksins 	Lýðveldisflokksins 
MHingar spreyuðu 	MH-ingar spreyjuðu  
Magnússson 	Magnússon 
Menntaskólan 	Menntaskólann 
Mininn 	Mikinn 
Mosvkuréttarhöldin 	Moskvuréttarhöldin 
Nafn stefnunar 	Heiti stefnunnar 
Napoleon 	Napóleon 
Napoleons 	Napóleons 
Napoléons 	Napóleons 
New Mexikó 	Nýju-Mexíkó 
Noreges 	Noregs 
Nítíu 	Níutíu 
Nútildags 	Nú til dags 
Nýji 	Nýi 
O'Brien-prófessir 	O'Brien-prófessor 
Orkuveitian 	Orkuveitan 
Papýusbúgarðurinn 	Papýrusbúgarðurinn 
Portúgalir 	Portúgalar 
Portúgalirnir 	Portúgalarnir 
PunkeðaRadiohead 	Punk eða Radiohead 
Pútin 	Putin 
Republikaninn 	Repúblikaninn 
Reykajvík 	Reykjavík 
Reykjavikur 	Reykjavíkur
Reykjavíkurflugallar 	Reykjavíkurflugvallar 
Reyndols 	Reynolds 
Ríkisendurskoðunnar 	Ríkisendurskoðunar 
Ríkisstjórnarfundurvar 	Ríkisstjórnarfundur var 
Ríksissjóði 	Ríkissjóði 
Sakvæmt 	Samkvæmt 
Samkeppnisstofnunnar 	Samkeppnisstofnunar 
Samkvætm 	Samkvæmt 
Seðlabankinnvissi 	Seðlabankinn vissi 
Sigfúsa 	Sigfúsi 
Silverstone-kappaksturinum 	Silverstone-kappakstrinum 
Sjóner 	Sjón er 
Skjálfandaafljóts 	Skjálfandafljóts 
Skálhoti 	Skálholti 
Skötuselurin 	Skötuselurinn 
Slökt 	Slökkt 
Soldánin 	Soldáninn 
Soldánin 	soldáninn 
Spenging 	Sprenging 
Stefánssonskoraði 	Stefánsson skoraði
Stjörnurar 	Stjörnurnar 
Strassbúrg 	Strassborg 
Stærðræðilegri 	Stærðfræðilegri 
Stóalana 	Stólana 
Stóru-Llaxá 	Stóru-Laxá 
Störnunni 	Stjörnunni 
Surstey 	Surtsey 
Sádía-Arabíu 	Sádí-Arabíu 
Sómalir 	Sómalar 
Sóvíetríkjunum 	Sovétríkjunum 
Tailandi 	Taílandi 
Taltað 	Talað 
Tengingskast 	Teningskast 
Tilgangurin 	Tilgangurinn 
Tjadvatn 	Tsjad-vatn 
Tobago 	Tóbagó 
Trinidad 	Trínidad 
Trúarjáninguna 	Trúarjátninguna 
Tákning 	Táknin 
Tórah 	Tórunnar 
TöframaðurinnEinar Mikaelog töfrakonanViktoríasýndu 	Töframaðurinn Einar Mikael og töfrakonan Viktoría sýndu  
Unverjum 	Ungverjum 
Uppskriftinar 	Uppskriftirnar 
Uumboðsmaður 	Umboðsmaður
Vegerðarinnar 	Vegagerðarinnar 
Veiiðin 	Veiðin 
Veiðiáðgjöf 	Veiðiráðgjöf 
Verkmannaflokkinum 	Verkamannaflokknum 
Verkmannaflokkurinn 	Verkamannaflokknum 
Verkmannaflokkurinn 	Verkamannaflokkurinn
Verkmannaflokssins 	Verkamannaflokssins 
Verrskólans 	Verzlunarskólans 
Verzlunarkóla 	Verzlunarskóla 
Verzlóstollti 	Verzlóstolti 
Vesturfjöðum 	Vestfjörðum 
Viðeyjarkluastur 	Viðeyjarklaustur 
Víkarinnar 	Víkur 
Vírussýking 	Veirusýking
Wahhabi trúarinna 	wahhabi-trúarinnar 
a 	að 
afbrygðileg 	afbrigðileg 
afhverju 	af hverju 
afrennslulaus 	afrennslislaus 
afsökunnar 	afsökunar 
aftöðu 	afstöðu 
afurður 	afurðir 
aldist 	ólst 
aldrinu 	aldrinum 
all 	alla 
all 	allt 
allaflestir 	allflestir 
allls 	alls 
alls 	alls 
allstaðar 	alls staðar 
allveg 	alveg 
allvega 	allavega 
allþekkt 	alþekkt 
almannréttur 	almannaréttur 
alrei 	aldrei 
alsherjar verkfalls 	allsherjarverkfalls 
alsráðandi 	allsráðandi 
altof 	alltof 
altöru 	ölturu 
alvit 	alvitur 
alþjólegu 	alþjóðlegu 
andlytslyftingu 	andlitslyftingu 
andmældi 	andmælti 
andstæðningum 	andstæðingnum 
andyrinu 	anddyrinu 
angistarköst 	kvíðakast 
annann 	annan 
annara 	annarra 
annða 	annað 
anorexísu 	lystarstols 
appelsínubörkin 	appelsínubörkinn 
arum 	árum 
atburðarásinnar 	atburðarásarinnar 
atvinnháttum 	atvinnuháttum 
atvinnu ökuskírteni 	atvinnuökuskírteini 
aukaspyurnu 	aukaspyrnu 
auðmagnins 	auðmagnsins 
auðmana 	auðmanna 
auðveldarar 	auðveldara
auðvellt 	auðvelt 
auðvita 	auðvitað 
aða 	að 
aðalega 	aðallega 
aðaltóftnina 	aðaltóftina 
aðein 	aðeins 
aðilla 	aðila 
aðstandani 	aðstandandi 
aður 	áður 
aðveldlega 	auðveldlega 
bandaríkjaforseta 	Bandaríkjaforseta
bandrísk 	bandarísk 
bankastarfssemi 	bankastarfsemi 
bannka 	banka
barrokkpopp 	barokkpopp 
baríntónsöngvari 	barítónsöngvari 
bassalaeikarinn 	bassaleikarinn 
bauðs 	bauðst
bennt 	bent 
bilunnar 	bilunar 
bitpopphljómsveitana 	bitpopphljómsveitanna 
blátti 	blárri 
blústónlistarhátið 	blústónlistarhátíð 
blústónlistarsefna 	blústónlistarstefna 
borgarstjórnans 	borgarstjórans 
borgarstjórni 	borgarstjóri 
borginnni 	borginni 
botnin 	botninn 
brautriðjandi 	brautryðjandi 
brautriðjendum 	brautryðjenda 
brautskránir 	brautskráðir 
breiðfiskri 	breiðfirskri 
brellibrögð 	bellibrögð
breytnigar 	breytingar 
breytst 	breytast 
brezki 	breski 
briddir 	bryddir 
brjótsti 	brjósti 
brotust 	brutust 
bráust 	braust 
bráðabrigðabrú 	bráðabirgðabrú 
bráðabyrgðaskáli 	bráðabirgðaskáli 
bréfaútgefundum 	bréfaútgefendum 
brötum 	bröttum 
brúðuvag 	brúðuvagn 
buggð 	byggð 
bundar 	bundnar
bung 	bunga 
bygganefnd 	byggðanefnd 
byggjað 	byggt 
bygðin 	byggðin 
byrjendu 	byrjendur 
byðja 	biðja 
bæjarfulltúra 	bæjarfulltrúa 
bæjarstjóran 	bæjarstjórans 
bæjinn 	bæinn 
bæklinginum 	bæklingnum 
bærjarins 	bæjarins 
bókarspensl 	bókarspennsl 
bólustningar 	bólusetningar 
búfenað 	búfénað 
búffjárrækt 	búfjárrækt 
dauðasind 	dauðasynd 
dauðrefsingum 	dauðarefsingum 
deildarinn 	deildarinnar 
deildna 	deilda 
dekkjana 	dekkjanna 
demokrataflokksins 	demókrataflokksins 
ditta 	dytta 
dreyfa 	dreifa 
dreyfingu 	dreifingu 
drykkfelddan 	drykkfelldan 
drógst 	dróst 
dungað 	dugnað 
dvíandi 	dvínandi 
dvö 	dvöl 
dyrlingi 	dýrlingi 
dægrstyttingar 	dægrastyttingar 
díselllítranum 	dísillítranum 
díselolíu 	dísilolíu 
dómHéraðsdóms 	dóm Héraðsdóms 
döknuðu 	dökknuðu 
dýrinn 	dýrin 
efahyggjumennirnireru 	efahyggjumennirnir eru 
efahygju 	efahyggju 
efir 	eftir 
eftinöfnum 	eftirnöfnum
eftirfarndi 	eftirfarandi 
eftr 	eftir 
eftuir 	eftir 
eigenda 	eiganda 
eignkonu 	eiginkonu 
eilfíð 	eilífð 
einfallt 	einfalt 
eingin 	eigin 
eingungis 	einungis 
eingungu 	eingöngu 
einhverji 	einhverri 
einhverntíman 	einhvern tímann 
einhverrs 	einhvers 
einhversskonar 	einhvers konar 
einig 	einnig 
einkenntist 	einkenndist 
einkonar 	einskonar 
einngi 	einnig 
einning 	einnig 
einokunnarverslunar 	einokunarverslunar 
einstaklingin 	einstaklinginn 
einstdæmi 	einsdæmi 
einsæðrar 	einstæðrar 
einunings 	einungis 
einvers 	einhvers 
eirplat 	eirplata 
eistaklingurinn 	einstaklingurinn 
eitthundrað 	eitt hundrað 
eitthver 	einhver 
eitthverja 	einhverja 
eitthverjum 	einhverjum 
eitthvern 	einhvern 
eitthvers allt 	einhvers alls 
eki 	ekki 
ekk 	ekki 
eldsukpptök 	eldsupptök 
embættirsgjörð 	embættisgjörð 
emileraðir 	emeleraður 
endan 	endann 
endasstöð 	endastöð 
endureisa 	endurreisa 
endurhljóðblöndunarmeisturun 	endurhljóðblöndunarmeisturum 
endurstaka 	endurtaka 
endurverkja 	endurvekja 
engann 	engan 
enkenndist 	einkenndist 
ent 	en 
erfarið 	er farið 
erfiðann 	erfiða 
erfðablöndum 	erfðablöndun 
erur 	eru 
eryu 	eru 
eyjuma 	eyjuna 
eylítið 	eilítið 
eyðslufyllerýi 	eyðslufylleríi 
eð 	sem 
eðlisþynd 	eðlisþyngd 
fallar 	fjallar 
fangakastallans 	fangakastalans 
fanst 	fannst 
farmhaldi 	framhaldi 
fassan 	fastan 
fasstar 	fastar 
fasteiganna 	fasteignanna 
feikivinæl 	feikivinsæl 
fellibyjla 	fellibylja 
feministi 	femínisti 
fernhyrndu 	ferhyrndu 
fertugsaldi 	fertugsaldri 
ferðaskrifstaofa 	ferðaskrifstofa 
ffrumvarp 	frumvarp 
filippínski 	filippeyski 
filippískum 	filippseyskum 
fimmtugann 	fimmtugan 
fimtán 	fimmtán 
finndist 	fyndist 
firir 	fyrir 
fjarskildar 	fjarskyldar 
fjlótt 	fljótt 
fjárhagsörðuleika 	fjárhagsörðugleika 
fjárhagsörðuleikunum 	fjárhagsörðugleikum 
fjármagnshöfum 	fjármagnshöftum 
fjármálráðherra 	fjármálaráðherra 
fjárstyrkum 	fjárstyrkjum 
fjórtða 	fjórða 
fjölbreitta 	fjölbreytta 
fjölbreittara 	fjölbreyttara 
fjöldabyggina 	fjölda bygginga 
fjöldan 	fjöldann 
fjöldaoft 	margoft 
fjöldataöluna 	fjöldatöluna 
fjölmiðunum 	fjölmiðlunum 
fjörtíu 	fjörutíu 
fjöskydur 	fjölskyldur 
flaueliskaka 	flauelskaka 
fleirra 	fleira  
fleirri 	fleiri 
fleiru 	fleira 
fleitir 	fleytir 
fleygð 	fleygði 
fljótega 	fljótlega 
fljótelga 	fljótlega 
flugtímarisins 	flugtímaritsins 
flutist 	fluttist 
fluttin 	flutti 
fluttningi 	flutningi 
flótlegast 	fljótlegast 
flúorljósi 	flúrljós 
folk 	fólk 
fomaður 	formaður 
fornleifarrannsóknir 	fornleifarannsóknir 
forráðamen 	forráðamenn 
forsetan 	forsetann 
forsteatíð 	forsetatíð 
forsætisræðherra 	forsætisráðherra 
framaf 	fram af 
framfjóðenda 	frambjóðanda 
framfæturnar 	framfæturna 
framhaldsskólnum 	framhaldsskólanum
framistöðu 	frammistöðu 
framkæmdar- 	framkvæmdar- 
frammhaldið 	framhaldið 
framsóknu-rokki 	framsækið rokk 
framvkæmdum 	framkvæmdum 
framúr 	fram úr 
freistust 	freistuðust 
frestingar 	freistingar 
friðsamlegari 	friðsamlegri 
fráfræði 	fáfræði 
fréttyum 	fréttum 
fundit 	fundist 
furðskepnan 	furðuskepnan
fyirr 	fyrir 
fynndið 	fyndið 
fyr 	fyrr
fyri 	fyrir 
fyribæri 	fyrirbæri 
fyrimann verið 	fyrirmann 
fyrirlið 	fyrirliði 
fyrirpsurnir 	fyrirspurnir 
fyrirtæksins 	fyrirtækisins 
fyrirtækum 	fyrirtækjum 
fyrrvernandi 	fyrrverandi 
fyrðum 	firðum 
færrri 	færri 
félagsheildinn 	félagsheildin 
félgaslífið 	félagslífið 
fést 	fékkst 
fók 	fólk 
fótana 	fótanna 
förunatur 	förunautur 
gagngrunns triggerum 	gagnagrunns gikkjum 
gagngrýni 	gagnrýni 
gagnráð 	gangráð 
gangkynhneigðum 	gagnkynhneigðum 
ganglegum 	gagnlegum 
gangvart 	gagnvart 
gannislag 	gamnislag 
gegkk 	gekk
gengdarlausra 	gegndarlausra 
gengdarlausum 	gegndarlausum 
gengdi 	gegndi 
genge 	gengu 
ghafi 	hafi 
greinþar 	grein þar 
grendinni 	grenndinni 
greyjinu 	greyinu
griðalega 	gríðarlega 
grunnskólamenntunninnar 	grunnskólamenntunnarinnar 
gríðalega 	gríðarlega 
grót 	grjót 
gullmyllan 	gullnáma 
guðana 	guðanna 
gáu 	gráu 
gírkasavandræði 	gírkassavandræði 
hafnarsvæðisisn 	hafnarsvæðisins 
hafstaum 	hafstraum 
hafð 	hafði 
hamlaust 	hamslaust 
han 	hann 
handana 	handanna 
handknatleiksstúlka 	handknattleikskona 
handknatleiksstúlka 	handknattleiksstúlka 
handleggum 	handleggjum 
handrið 	handrit 
hanns 	hans
hanns 	hans 
harnað 	harðnað 
harðadiska 	harða diska 
harðadiska 	harðdiska 
harðjkarnapönkstefnunni 	harðkjarnapönkstefnunni 
hefbundin 	hefðbundin 
hefrur 	hefur 
hefu 	hefur 
hefðbundu 	hefðbundnu 
hefðbunin 	hefðbundin 
heilbriðisráðherra 	heilbrigðisráðherra 
heimaslóðirnir 	heimaslóðirnar 
heimaveilli 	heimavelli 
heimilidir 	heimildir 
heimilsmaður 	heimilismaður 
heimkinnum 	heimkynnum 
heimsstyrjaldinnar 	heimsstyrjaldarinnar 
heimstyrjöldinna 	heimsstyrjöldinni 
hemi 	heimi 
hengu 	héngu 
henntist 	hentist 
henntugasta 	hentugasta 
hentunum 	hnetunum 
hertogakrórónan 	hertogakórónan 
hertogaynjaf 	hertogaynja 
herðnaðarlega 	hernaðarlega 
heyvinnlsu verkfæri 	heyvinnsluverkfærum 
hilja 	hylja 
hinnihaldi 	innihaldi 
hinns 	hins 
hinsv egar 	hins vegar 
his 	hið 
hitastiginn 	hitastigið 
hjartslátti 	hjartslætti 
hjóðupptöku 	hljóðupptöku 
hliðiná 	hliðina á 
hljomsveitin 	hljómsveitin 
hljókerfi 	hljóðkerfi 
hljómsveiarinnar 	hljómsveitarinnar 
hljómsveitinFleetwood Macmuni 	hljómsveitin Fleetwood Mac muni 
hljómsveitini 	hljómsveitinni 
hljómveitum 	hljómsveitum 
hljóðgerfla 	hljóðgervla 
hljóðmaði 	hljómaði 
hllutinn 	hlutinn 
hltutverk 	hlutverk 
hluat 	hlaut 
hlustðu 	hlustuðu 
hlutfal 	hlutfall 
hlutsta 	hlusta 
hlómar 	hljómar 
hlýjann 	hlýjan 
hlýtar 	hlítar 
hneiksluð 	hneyksluð 
hollann 	hollan 
hreinilega 	hreinlega 
hrekkjagjörn 	hrekkjótt 
hrifinir 	hrifin 
hryggstykkið 	hryggjarstykkið 
hryðjuverkjum 	hryðjuverkum 
hrökuðu 	hrakaði 
hughvarft 	hughvarf 
hugsunagangur 	hugsanagangur 
hun 	hún 
hundruði 	hundruð 
hundruðir 	hundruð 
hungurssneyð 	hungursneyð 
hven 	hvern 
hvenig 	hvernig 
hverjari 	hverri 
hverngi 	hvernig 
hvernir 	hvernig 
hvorteð 	hvort eð 
hvítabjörnin 	hvítabjörninn 
hyggðist 	hygðist 
háaðillinn 	fyrir háaðalinn 
háfleiks 	hálfleiks 
háfleikstölur 	hálfleikstölur
háflnaður 	hálfnaður 
hákólanám 	háskólanám
hálendinsins 	hálendisins 
hálfeik 	hálfleik 
hármarki 	hámarki 
hásterkt 	hástert 
hátínni 	hátíðinni 
hætlar 	ætlar 
hæðsta 	hæsta 
hæðsti 	hæsti 
hæðstu 	hæstu 
héllt 	hélt 
höfundin 	höfundinn 
höfuðborgarninnar 	höfuðborgarinnar 
högi 	höggi 
högðu 	einnig höfðu 
höufm 	höfum 
hússin 	hússins 
hýbýli 	híbýli 
inblástur 	innblástur 
innaginn 	innganginn 
innanfrá 	innan frá 
innanhúshönnun 	innanhússhönnun 
inneignanótu 	inneignarnótu 
innfæddann 	innfæddan 
inngangsgöngum 	inngöngum 
innihéltu 	innihalda 
innliksa 	innlyksa 
innlimu 	innlimuðu 
innvíga 	innvígðra 
inní 	inn í 
inní 	inni í 
insigli 	innsigli 
insligl 	innsigli 
inst 	innst 
isnnar 	sinnar 
iðjuleysingar 	iðjuleysingjar 
iðnaðarfyrirtækjar 	iðnaðarfyrirtækja 
iðullega 	iðulega 
jafnfram 	jafnframt 
jarðvegnum 	jarðveginum 
jaðfundnum  	jarðfundnum
jeppan 	jeppann 
jöfunarþró 	jöfnunarþró 
kafti 	krafti 
kakter 	karakter 
kaldt 	kalt 
kalífarninr 	kalífarnir 
kandidatspróf 	kandídatspróf 
kanntinum 	kantinum 
kanski 	kannski 
kantmanninm 	kantmanninum 
karneval 	Karnival 
karneval 	karnival 
karnevalsprinsinum 	karnivalsprinsinum 
karnevalssafnið 	karnivalssafnið 
kasstar 	kastar 
katalanska 	katalónska 
keisarafjölskyldunar 	keisarafjölskyldunnar 
keisaraynjunar 	keisaraynjunnar 
keistarynju 	keisaraynju 
kensluháttum 	kennsluháttum 
keppiefli 	keppikefli 
keppninar 	keppninnar 
keppninna 	keppninni 
kirkjunstaðnum 	kirkjustaðnum 
kissa 	kyssa 
kjarnan 	hismið 
kjálpaharpa 	kjálkaharpa 
klafs 	krafs 
klaufanlegt 	klaufaleg 
klárlegt 	klárt 
kmoast 	komast 
knattspyrnusasmbandsins 	knattspyrnusambandsins 
komedía 	kómedía 
kommonistaflokksins 	kommúnistaflokksins 
konuninni 	konunni 
kosningana 	kosninganna
kosningana 	kosningarnar 
kreptan 	krepptan 
krossnefar 	krossnefir 
kufungamyndirnar 	kuðungamyndirnar 
kvennar 	kvenna 
kvennkyns 	kvenkyns 
kvennmenn 	kvenmenn 
kvikinnskots 	kvikuinnskots 
kvikmyndahátiðir 	kvikmyndahátíðir 
kyningar 	kynningar 
kynþáttsins 	kynþáttarins 
kínvesk 	kínversk 
kóngnum 	kónginum 
kóreanska 	kóreska 
kóreanskri 	kóreskri 
kóreanskur 	kóreskur 
kóronur 	kórónur 
kúnnan 	kúnnann 
lagahöfunum 	lagahöfundum 
landai 	landi 
landsliðsþjállfari 	landsliðsþjálfari 
landslðisþjálfara 	landsliðsþjálfara 
langin 	langinn 
langvegginir 	Langveggirnir 
langði 	langaði 
lausann 	lausan 
lausrr 	lausri 
laveiðiá 	laxveiðiá 
leggji 	leggi 
leggði 	legði 
legst 	leggst 
leikkkona 	leikkona 
leikritisins 	leikritsins 
leiðingjarnt 	leiðigjarnt 
leiðnni 	leiðinni 
lespíur 	lesbíur 
leyddi 	leiddi 
leyddu 	leiddu 
leyta 	leita 
liklega 	líklega 
lipurlegum 	liprum 
lirfunar 	lirfurnar 
listamðurinn 	listamaðurinn 
litaúralið 	litaúrvalið 
litbrygði 	litbrigði 
liðinum 	liðunum 
liðuðst 	liðuðust 
ljúfengan 	ljúffengan 
lls 	alls 
llykilorð 	lykilorð 
lofárásum 	loftárásum 
lokst 	loks 
lugnakrabbamein 	lungnakrabbamein 
lugnakrabbameini 	lungnakrabbameini 
lyfum 	lyfjum 
lyggja 	liggja 
lánaðann 	lánaðan 
lífeyrisgreiðslan 	lífeyrisgreiðslna 
líffrænum 	lífrænum 
lífssins 	lífsins 
líkaman 	líkamann 
líkamslegaformi 	líkamlega formi 
lírunar 	lírunnar 
lítlu 	litlu 
lögreglumannannna 	lögreglumannanna 
lögreglunar 	lögreglunnar 
lögreglunna 	lögreglunnar 
lögreglustjóran 	lögreglustjórann 
lögrelgu 	lögreglu 
lýðræðishreifinga 	lýðræðishreyfinga 
lýðvelsis 	lýðveldisins 
mai 	maí 
makríllnn 	makríll 
mannana 	mannanna 
mannesku 	manneskju 
mannnlegs 	mannlegs 
mannseskja 	manneskja 
mannvistaleyfar 	mannvistarleifar 
margskonarar 	margskonar 
maríjuana 	maríjúana 
med 	með 
meginn 	megin 
megnmegnis 	mestmegnis 
meirimáttar 	meiri máttar 
meistaratitlanna 	meistaratitlana 
meistaverk 	meistaraverk 
mennigarsvæða 	menningarsvæða 
menntunnar 	menntunar 
mentun 	menntun 
mestann 	mestan 
mexikókst 	mexíkóskt 
meðann 	meðan 
meðlimirQueenmeðAdam Lambertsem 	meðlimir Queen með Adam Lambert sem 
mikin 	mikinn 
miklið 	mikið 
miljarða 	milljarða 
miljarðar 	milljarða 
miljarðar 	milljarðar 
miljónir 	milljónir 
milljöðrum 	milljörðum 
minkaskinn 	minnkaskinna 
minkuðu 	minnkuðu 
minnimáttar 	minni máttar 
mishamingjusamt 	mis hamingjusamt 
miskilja 	misskilja 
miskun 	miskunn 
miskunsamur 	miskunnsamur 
mismundandi 	mismunandi 
misttu 	misstu 
mistókast 	mistókst 
miðan 	miðann 
miðjann 	miðjan 
miðjantíunda áratuguginn 	miðjan tíunda áratuginn 
miðlil 	miðil 
miðsonur 	miðjusonur 
miðstöðum 	miðstöðvum 
mkinn 	mikinn 
mnnkar 	minnkar 
mogsturinn 	moksturinn 
moksunnar 	moskunnar 
mungígan 	munngígjan 
munnanns 	munnans
myndustu 	mynduðust 
mynlistarmaður 	myndlistarmaður 
mynnast 	minnast 
málfræðinginum 	málfræðingnum 
málsmíði 	málmsmíði 
málískur 	mállýskur 
mánuða 	mánuði 
míkrógröm 	míkrógrömm 
mómælin 	mótmælin 
möffinsform 	múffuform 
mörgþúsund 	mörgum þúsundum 
múslimalöndum 	löndum þar sem múslímar búa 
múslimskir 	múslímskir 
múslimskum 	múslímskum 
múslimstrúar 	múslímar 
nagdýum 	nagdýrum 
naglan 	naglann 
nauðsinlegur 	nauðsynlegur 
nauðsynum 	nauðsynjum 
nefndana 	nefndanna 
nefninlega 	nefnilega 
neita 	neyta 
nemd botnsskimun 	nefnd botnskimun 
netyenda 	neytenda 
neðanjarðarbirgi 	neðanjarðarbyrgi 
niðrá 	niður á
niðrá 	niður á 
niðurbtoin 	niðurbrotin 
niðureftir 	niður eftir
niðurröðum 	niðurröðun 
niðurstöðuum 	niðurstöðum um 
nokkir 	nokkrir 
nokkkurri 	nokkurri 
nokkura 	nokkurra 
nokkurntíman 	nokkurn tímann 
nokkurð 	nokkuð 
norðuhveli 	norðurhveli 
nosrka 	norska 
notaðaur 	notaður 
náskilið 	náskylt 
náttúrlega 	náttúrulega 
næringaríkar 	næringarríkar 
nærinu 	næringu 
nærra 	nærri 
næsstu 	næstu 
nó 	nóg 
nún 	nú 
núþegar 	nú þegar 
nýji 	nýi 
nýjir 	nýir 
nýjársnótt 	nýársnótt 
nýum 	nýjum 
nýðast 	níðast 
ofaná 	ofan á 
offast 	oftast 
ofðið 	orðið 
ofþennsla 	ofþensla 
ofþennslu 	ofþenslu 
olíbrunnur 	olíubrunnur 
orkukræft 	orkufrekt 
orðinir 	orðnir 
orðstí 	orðstír 
palestískan 	palestínskan 
pappírsklippi 	klippimyndaforminu 
partu 	partur 
penginum 	peningum 
peningunu 	peningunum 
plötufyritækjum 	plötufyrirtækjum 
post-rokk 	póst-rokk 
prjónapreysur 	prjónapeysur 
prufun 	prufa 
prófesor 	prófessor 
prófkjara 	prófkjöra 
puntkum 	punktum 
póstskipun 	póstskipinu 
rannasaka 	rannsaka 
rauðann 	rauðan 
refað 	refsað 
regnskúum 	regnskúrum 
regubundna 	reglubundna 
reikningin 	reikninginn 
reipitogu 	reiptitogi 
reitamunsturum 	reitamunstrum 
reykræstinu 	reykræstingu 
reystir 	reistir
rifbrein 	rifbein 
ruppluðu 	rupluðu 
ráköst 	fráköst 
rífuðust 	rifust 
ríkissakskóknari 	ríkissaksóknari 
ríkissins 	ríkisins 
ríkisstjórnarinna 	ríkisstjórnarinnar 
ríkistjórn 	ríkisstjórn 
rómanríska 	rómantíska 
rúsinufingur 	rúsínufingur 
saksóknaranns 	saksóknarans 
saltkjets 	saltkjöts 
samanlagtt 	samanlagt 
samantengdum 	samtengdum 
samenstendur 	samanstendur 
samfélagins 	samfélagsins 
samfélagögum 	samfélögum 
samfélgas 	samfélags
samfélgasins 	samfélagsins 
samkeppnhæfni 	samkeppnishæfni 
samkynneigðir 	samkynhneigðir 
samkæmt 	samkvæmt 
samningu 	samningur 
samninum 	samningum 
samræmduprófin 	samræmdu prófin 
samstarsamning 	samstarfssamning 
samstyllingu 	samstillingu 
samstöðubóum 	samstöðubótum 
samvkæmt 	samkvæmt 
sandugan 	sendinn 
sannleikan 	sannleikann 
sedm 	sem 
sem ahfa 	hafa 
semeiginlegu 	sameiginlegu 
septmeber 	september 
settst 	settist 
seú 	séu  
sigdalinum 	sigdalnum 
silungin 	silunginn 
sind 	synd 
sitjast 	setjast 
siðari 	síðari 
sjoppumeningu 	sjoppumenningu 
sjáfsþurfarbúskap 	sjálfsþurftarbúskap 
sjálfstögð 	sjálfsögð 
sjálfsæðari 	sjálfstæðari 
sjálfþurftarbúskað 	sjálfsþurftarbúskap 
sjálskipuðum 	sjálfskipuðum 
sjávaútvegsmála 	sjávarútvegsmála 
sjíamúslimar 	sjítamúslimar 
sjónvarpsstöðum 	sjónvarpsstöðvum 
sjúkarhúsinu 	sjúkrahúsinu 
sjúkdómni 	sjúkdómi 
skammst 	skamms 
skamt 	skammt 
skapst 	skapast 
skattlaggningu 	skattlagningu 
skemmtielgt 	skemmtilegt 
skipts 	skipst 
skonar 	konar 
skotævingarsvæði 	skotæfingarsvæði 
skoðanna 	skoðana 
skydur 	skyldur 
skærst 	skært 
skírteni 	skírteini  
skíðagömgukappinn 	skíðagöngukappinn 
skólaandan 	skólaandann 
sköpunnarinnar 	sköpunarinnar 
skýn 	skín 
skýrlífi 	skírlífi 
skýrskotun 	skírskotun 
slíkum frammistöðum 	slíkri frammistöðu 
slökklið 	slökkvilið 
smyndinni 	kvikmyndinni 
smáminnkanndi 	smáminnkandi 
smáskifan 	smáskífan 
smásmíð 	smásmíði 
snoturn 	snotran 
snuðrulaust 	snurðulaust 
snúm 	snúum 
snýkill 	sníkill 
snýstu 	snýst 
so 	svo 
spenninngur 	spenningur 
spjallþáttastjórnanandanum 	spjallþáttastjórnandanum 
spreya 	spreyja 
sprotin 	sprottin 
spurja 	spyrja 
spíral turni 	spíralturni
spítulum 	spítölum 
ssek 	sek
stafesti 	staðfesti 
stafrækti 	starfrækti 
stangt 	strangt 
staðfestngar 	staðfestingar 
stefnunar 	stefnunnar 
steinninn 	steininn 
stemmt 	stefnt 
sterkann 	sterkan 
steyma 	streyma 
stjarfklofa 	stjarfur 
stjórarandstöðunnar 	stjórnarandstöðunnar 
stjórnarformaðu 	stjórnarformaður 
stjórnarskránna 	stjórnarskrána 
stjórnmálaum 	stjórnmálum 
stjórnmálaþáttöku 	stjórnmálaþátttöku 
stjórnsýslu stofnanna 	stjórnsýslustofnana 
stjórvöld 	stjórnvöld 
stollti 	stolti 
stoltann 	stoltan 
stoðsenidngar 	stoðsendingar 
stra x 	strax 
strekan 	sterkan 
strákrnir 	strákarnir 
strórsteyminu 	stórstreyminu 
stundarákvörðun 	skyndiákvörðun 
styrir 	stýrir 
styrktaraðil 	styrktaraðila 
styðju 	styðja 
stækkunnar 	stækkunar 
stæsta 	stærsta 
stórann 	stóran 
stóriðjur 	stóriðja 
stórkostlegann 	stórkostlegan 
stöugri 	stöðugri 
stöðvarhússgrunninum	stöðvarhúsgrunninum
stúdentaleikfélagaið 	stúdentaleikfélagið 
stúdentsskirteini 	stúdentspróf 
sumsstaðar 	sums staðar 
sumurs 	sumars 
sunnudagskveldi 	sunnudagskvöldi 
suðurendan 	suðurendann 
sveitarstjórnarkosningana 	sveitarstjórnarkosningarnar
sveitnarinnar 	sveitarinnar 
sviftingum 	sviptingum 
svipaðann 	svipaðan 
svosem 	svo sem 
svuntuþeyjara 	svuntuþeysara 
svuntuþeyjarar 	svuntuþeysarar 
synfónía 	sinfónía 
synfóníustjórnandi 	sinfóníustjórnandi 
synunum 	sonum 
sætingi 	sætindi 
sérfærðiráðgjafar 	sérfræðiráðgjafar 
sérkennnilegt 	sérkennilegt 
sérst 	sést 
sérstakann 	sérstakan
sérstklega 	sérstaklega 
sí vaxa 	
sínni 	sinni 
sínt 	sýnt 
síðaustu 	síðustu 
síðstliðið 	síðastliðið 
síðstu 	síðustu 
síðsutu 	síðustu 
sókt 	sótt 
sólarljóst 	sólarljós 
söluhætsta 	söluhæsta 
sönkona 	söngkona 
súkdómi 	sjúkdómi 
sýnr 	snýr 
sýnti 	sýndi 
takas 	takast 
takmarkaðann 	takmarkaðan 
talnan 	talna 
talsverjar 	talsverðar 
talvan 	tölvan
talvan 	tölvan 
tegundinn 	tegundin 
tegundur 	tegundir 
teigðu 	teygðu 
tengls 	tengsl 
tenglsum 	tengslum 
teninginum 	teningnum 
textíleifum 	textílleifum 
ti 	til 
tii 	til 
tildæmis 	til dæmis 
tilfinninngarokk 	tilfinningarokk 
tilganslaus 	tilgangslaus 
tilhneiginu 	tilhneigingu 
tilhneygingu 	tilhneigingu 
till 	til 
tilliembætti 	tylliembætti 
tilliástæður 	tylliástæður 
tilllaga 	tillaga 
tilskylinn 	tilskilinn 
tiltöluega 	tiltölulega 
tiltörulega 	tiltölulega 
tjaldurs 	tjalds 
tl 	til 
tlberasmjör 	tilberasmjör 
togararralli 	togararalli 
top 	topp 
torfærin 	torfarin 
transtónslistar 	transtónlistar 
traustverðugari 	traustverðugri 
tropmetleikaranum 	trompetleikaranum 
trúnaðs 	trúnaðar 
ttákn 	tákn 
tugguð 	tuggið 
tveimru 	tveimur 
tvem 	tveim
tvöhundruð 	tvö hundruð 
tyggigúmmí popp 	tyggjópopp 
tæmzt 	tæmst 
tímabilinnu 	tímabilinu 
tímabundumð 	tímabundnum
tíman 	tímann 
tímanns 	tímans 
tímas 	tímans 
tóks 	tókst 
tólkst 	tókst 
tónlisastefnum 	tónlistarstefnum 
tónlisitn 	tónlistin 
tónlistamenn 	tónlistarmenn 
tónlistarsefnunum 	tónlistarstefnunum 
tónlistarsumarbúði 	tónlistarsumarbúðir 
tónskáldinn 	tónskáldin 
tósskaparáhöldum 	tóskaparáhöldum 
töggl 	tögl 
tölvert 	töluvert 
umborð 	um borð 
umkringur 	umkringdur 
umræðuum 	umræðu um 
undandarið 	undanfarið 
undanskyldum 	undanskildum 
undantekngingartilvikum 	undantekningartilvikum 
undantekninar 	undantekningar 
undir búningin 	undirbúninginn 
uppgröftin 	uppgröftinn 
uppgröftnum 	uppgreftinum 
uppgvötun 	uppgötvun 
uppgötvannir 	uppgötvanir 
upplifaði 	upplifði 
uppoði 	uppboði 
upprunar 	upprunnar 
upprunið 	upprunnið 
upptölu 	upptöku 
uppá 	upp á 
uppúr 	upp úr 
utanríkisráðherran 	utanríkisráðherrann
vaið 	við 
vallarstarfsmannin 	vallarstarfsmanninn 
vandræðanleg 	vandræðaleg 
vaniluskyr 	vanilluskyr 
vaqr 	var 
varirirnar 	varirnar 
varðadi 	varðandi 
varðarn 	varðar 
vegbrý 	vegbrýr 
vegfarnenda 	vegfarenda 
veirð 	verið 
vekji 	veki 
venjúlega 	venjulega 
ver samfeld 	var samfelld 
veriði 	verið 
verkefnir 	verkefnin 
verkmannaflokkurinn 	verkamannaflokkurinn 
verlsað 	verslað 
verlunar 	verslunar 
verslunirnar 	verslanirnar 
verðalag 	verðlag 
verðlunagrip 	verðlaunagrip 
vestina 	vextina 
vetir 	veitir 
vetvangi 	vettvangi 
veðmæti 	verðmæti 
viikunni 	vikunni 
viljat 	vilja 
viljii 	vilji 
villdýralaganna 	villidýralaganna 
vinnslustingi 	vinnslustigi 
vinstramegin 	vinstra megin 
vinældum 	vinsældum 
viriðist 	virðist 
virktasta 	virkasta 
viru 	voru 
virðst 	virst 
visitasía 	vísitasía 
viðbröðgum 	viðbrögðum 
viðhadið 	viðhaldið 
viðmörkum 	viðurlögum 
viðuppgröft 	við uppgröft 
viðurkenntar 	viðurkenndar 
vonbrygðin 	vonbrigðin 
vonbrygðum 	vonbrigðum 
vondukarlarnir 	vondu karlarnir 
vopunum 	vopnum 
vorinn 	vorin 
voru aðalega 	var aðallega 
vour 	voru 
vápnalausar 	vopnlausar 
vænann 	vænan 
vídeómyndum 	myndböndum 
víjkandi 	víkjandi 
vítaspyrnukeppi 	vítaspyrnukeppni 
víðamiklar 	viðamiklar 
víðfem 	víðfeðm 
vð 	við 
vörlslu 	vörslu 
vöruafgeriðslur 	vöruafgreiðslur 
yffirráð 	yfirráð 
yfirheyrslunar 	yfirheyrslunnar 
yfirstandi 	yfirstandandi 
yfirvegunnar 	yfirvegunar 
yfirvovandi 	yfirvofandi 
Árdalsafossi 	Árdalsfossi 
Íhaldsflokkinum 	Íhaldsflokknum 
Íraskar 	Írakskar 
Ólfasvík 	Ólafsvík 
Ólympíhópi 	ólympíuhópi 
Ólympímótinu 	Ólympíumótinu 
Úkraínumönnu 	Úkraínumönnum 
Úngverjalandi 	Ungverjalandi 
Þessarri 	Þessari 
Þetat 	Þetta 
Þorgeði 	Þorgerði 
Þorteinsson 	Þorsteinsson 
Þónokkrir 	Þó nokkrir 
Þórvaldur 	Þorvaldur 
ábygðaleysi 	ábyrgðarleysi 
áfallt 	ávallt 
áfastann 	áfastan 
áfengjum 	áfengum 
áframaldandi 	áframhaldandi 
áfórmum 	áformum 
áhesrslu 	áherslu 
áhggyjur 	áhyggjur 
áhirf 	áhrif 
áhveðið 	ákveðið 
ákeðnu 	ákveðnu 
ákvörðunnar 	ákvörðunar 
áratugarinns 	áratugarins
áratuginum 	áratugnum
áratugsins 	áratugarins 
ásmeginn 	ásmegin 
ásás 	árás
ávalt 	ávallt 
áverkefa 	áverka 
áveða 	ákveða 
áðurnefnir 	áðurnefndir 
áðurupptekin 	áður upptekin 
áþreyfanlegi 	áþreifanlegi 
æfin 	ævin 
ættingar 	ættingjar 
ættkvískarinnar 	ættkvíslarinnar 
érekki 	ég er ekki 
íbúadreif 	dreifing íbúa 
ífið 	ívið 
ílla 	illa 
írösk 	írönsk 
íshokki 	íshokkí 
íslensra 	íslenskra 
ísoprópanóls 	ísóprópanóls 
íssöltu 	ísöltu 
óeyrða 	óeirða 
óeyrðunum 	óeirðunum 
óforskammanlegt 	óforskammað 
ógnanir 	ógnir
ógnarferð 	ógnarhraða 
óhefbundnum 	óhefðbundnum 
óhrekjanleikja 	óhrekjanleika 
óhugnarlegir 	óhugnanlegir 
ólympíuleikana 	ólympíuleikanna 
ónefndann 	ónefndan 
óprútinna 	óprúttinna 
órafmöguð 	órafmögnuð 
óreglubudnu 	óreglubundnu
ósamála 	ósammála 
óstöðuleika 	óstöðugleika 
ósæskileg 	óæskileg 
óvísindlegan 	óvísindalegan 
óðarlsmörkin 	óðalsmörkin 
óðauð 	afturgengin 
ödum 	öldum 
öfgamenninna 	öfgamennina 
ökuréttndi 	ökuréttindi 
ökuskírteni 	ökuskírteini 
ökuskírteni fyrir 	ökuskírteini til 
ökuskírtenið 	ökuskírteinið 
ökuskírtenum 	ökuskírteinum 
öldungardeildinn 	öldungadeildin 
örbrigð 	örbirgð 
örbygðina 	örbirgðina 
örkumlu 	örkumlun 
örofi 	örófi 
örskotstundu 	örskotsstundu 
öruggleg 	örugglega 
öryggisveita 	öryggissveita 
öðlst 	öðlast 
úrheli 	úrhelli 
úrhellinnu 	úrhellinu 
úrsltin 	úrslitin 
útaf 	út af 
útbreyðslu 	útbreiðslu 
útgáfufyrirtækisin 	útgáfufyrirtækisins 
útgáfunnu 	útgáfunni 
útlendiga 	útlendinga 
útlátinn 	útilátinn 
útskýria 	útskýra 
útskýrslu 	útskýringu 
útvarpstöðum 	útvarpsstöðvum 
útvarpsþáttarröðin 	útvarpsþáttaröðin 
útveru 	útiveru 
útýma  	útrýma 
ýfangsmikil 	umfangsmikil 
ýkji 	ýki 
ýminda 	ímynda 
ýmisar 	ýmsar 
ýmisum af 	ýmsum 
ýsmum 	ýmsum 
þaklátt 	þakklát 
þan 	þann 
þangskeggnum 	þangskegginu 
þankagagni 	þankagangi 
þarlendis 	þar 
þarlendis 	þar í landi 
þeass 	sér 
þeira 	þeir 
þeirr 	þeirra 
þekkingarfæðilega 	þekkingarfræðilega 
þenna 	þennan 
þennann 	þennan 
þernunar 	þernunnar 
þessarra 	þessara 
þessarrar 	þessarar 
þessarri 	þessari 
þessujm 	þessum 
þingkosningana 	þingkosningarnar 
þingkosningarnir 	þingkosningarnar
þingu 	þingi 
þjálfarin 	þjálfari 
þjóðaratkvæðagreriðslu 	þjóðaratkvæðagreiðslu 
þjóðarbrotana 	þjóðarbrotanna 
þjóðarflokkinum 	þjóðarflokknum 
þjóðarlflokkurinn 	þjóðarflokkurinn 
þjóðarmorðana 	þjóðarmorðanna 
þjóðernishiggja 	þjóðernishyggja
þjóðernishópanir 	þjóðernishóparnir 
þjóðfarinnar 	þjóðarinnar 
þjóðflokkinum 	þjóðflokknum 
þjóðhagsreikiningar 	þjóðhagsreikningar 
þrautsegju 	þrautseigju 
þrefallt 	þrefalt 
þremeningarnir 	þremenningarnir 
þressuvörn 	pressuvörn 
þriðjun 	þriðjung 
þroskaðari 	þroskaðri 
þríðja 	þriðja 
þróaðara 	þróaðra 
þróunnar 	þróunar 
þröskular 	þröskuldar 
þrú 	þrjú 
þrýsingi 	þrýstingi 
þsem 	sem 
þu 	þú 
þufti 	þurfti 
þurkaði 	þurrkaði 
þvi 	því 
þvíer 	því er 
þvó 	því 
þykis 	þykist 
þá bauðs 	bauðst 
þádaga 	þá daga 
þáttaka 	þátttaka 
þáttana 	þáttanna 
þáttarinns 	þáttarins 
þátttana 	þáttanna 
þáttöku 	þátttöku 
þæginlega 	þægilega 
þærra 	þeirra 
þætttinum 	þáttunum 
þónokkurrar 	þó nokkurrar 